status,card_present_flag,bpay_biller_code,account,currency,long_lat,txn_description,merchant_id,merchant_code,first_name,balance,date,gender,age,merchant_suburb,merchant_state,extraction,amount,transaction_id,country,customer_id,merchant_long_lat,movement
authorized,1,,ACC-1222300524,AUD,151.23 -33.94,POS,835c231d-8cdf-4e96-859d-e9d571760cf0,,Michael,5.71,8/1/2018,M,38,Sydney,NSW,2018-08-01T01:26:15.000+0000,6.42,feb79e7ecd7048a5a36ec889d1a94270,Australia,CUS-2142601169,151.21 -33.87,debit
authorized,1,,ACC-1222300524,AUD,151.23 -33.94,POS,f6d24b03-5ca8-4cb3-83e2-73db22103a8a,,Michael,0.25,8/7/2018,M,38,Rowville,VIC,2018-08-07T15:34:37.000+0000,5.46,34055a1bc26942a69ee70eab55d29cd5,Australia,CUS-2142601169,145.25 -37.91,debit
posted,,0,ACC-1222300524,AUD,151.23 -33.94,PAY/SALARY,,0,Michael,1002.38,8/7/2018,M,38,,,2018-08-07T17:00:00.000+0000,1002.13,add2ff36bbb94d2eabdbd5b41c78b501,Australia,CUS-2142601169,,credit
authorized,1,,ACC-1222300524,AUD,151.23 -33.94,POS,29110340-14ea-43b8-b60e-59c756b03fc3,,Michael,994.98,8/8/2018,M,38,Bondi Beach,NSW,2018-08-08T09:31:48.000+0000,7.4,1115b2ea0a1345fd9c4f541bc7784a1e,Australia,CUS-2142601169,151.27 -33.89,debit
authorized,1,,ACC-1222300524,AUD,151.23 -33.94,SALES-POS,6823b519-3882-4889-97f2-ab54da53f0a7,,Michael,977.88,8/8/2018,M,38,Bass Hill,NSW,2018-08-08T10:30:56.000+0000,17.1,36778499c9fe4ec6b149e6a794265215,Australia,CUS-2142601169,151 -33.9,debit
authorized,1,,ACC-1222300524,AUD,151.23 -33.94,SALES-POS,ee20c998-1621-488e-96ad-f8c1d8cb9799,,Michael,953.14,8/8/2018,M,38,Marrickville,NSW,2018-08-08T10:46:33.000+0000,24.74,70e5091f8e4a4975924985bca00d1edc,Australia,CUS-2142601169,151.15 -33.92,debit
authorized,1,,ACC-1222300524,AUD,151.23 -33.94,POS,a6d5b5b4-593b-409e-87f2-5754b053cd62,,Michael,942.02,8/8/2018,M,38,Mosman,NSW,2018-08-08T15:36:57.000+0000,11.12,deb145847190481a9ab310fb58a42d61,Australia,CUS-2142601169,151.24 -33.83,debit
authorized,1,,ACC-1222300524,AUD,151.23 -33.94,POS,3d42f4da-87cc-41d9-a2d0-f0fb9fc97f67,,Michael,922.17,8/8/2018,M,38,North Rocks,NSW,2018-08-08T15:42:48.000+0000,19.85,34c00ed142ff4ecf9b9e8c56eae0c152,Australia,CUS-2142601169,151.03 -33.77,debit
authorized,1,,ACC-1222300524,AUD,151.23 -33.94,SALES-POS,fd1c9a34-9224-4338-9716-e8f10005b83a,,Michael,908.81,8/8/2018,M,38,Alderley,QLD,2018-08-08T17:18:55.000+0000,13.36,8fa4c7428c6b489a81c1f5c7e86c1286,Australia,CUS-2142601169,153 -27.43,debit
authorized,1,,ACC-1222300524,AUD,151.23 -33.94,SALES-POS,26543f15-1756-4fe0-9feb-33a15bee4e60,,Michael,890.02,8/8/2018,M,38,Minchinbury,NSW,2018-08-08T18:58:55.000+0000,18.79,b3100dc2495e4ae48691b91d43041819,Australia,CUS-2142601169,150.83 -33.78,debit
authorized,1,,ACC-1222300524,AUD,151.23 -33.94,POS,0b987f8d-d345-4b1c-8113-b433631aae15,,Michael,885.24,8/8/2018,M,38,Liverpool,NSW,2018-08-08T23:50:15.000+0000,4.78,44e9a619eaa54ef38a77dc85970fda84,Australia,CUS-2142601169,150.92 -33.92,debit
authorized,1,,ACC-1222300524,AUD,151.23 -33.94,POS,5dadf9a3-bbd8-4944-ad92-35347499359c,,Michael,872.57,8/9/2018,M,38,Leichhardt,NSW,2018-08-09T01:01:23.000+0000,12.67,52779d7b528f4b178d2784f483070050,Australia,CUS-2142601169,151.16 -33.89,debit
authorized,1,,ACC-1222300524,AUD,151.23 -33.94,POS,9e416b5d-5d51-49ab-a38a-a55f33afadca,,Michael,864.46,8/9/2018,M,38,Sydney,NSW,2018-08-09T14:41:36.000+0000,8.11,663b374c5c3341eb82bd54b18f4f7805,Australia,CUS-2142601169,151.21 -33.87,debit
posted,,,ACC-1222300524,AUD,151.23 -33.94,PAYMENT,,,Michael,803.7,8/9/2018,M,38,,,2018-08-09T19:00:00.000+0000,50,6cd050b5e92e4f7cb787a7ec57a01461,Australia,CUS-2142601169,,debit
authorized,1,,ACC-1222300524,AUD,151.23 -33.94,SALES-POS,aa5aa2e9-e9b4-46a6-a8ad-d723edc8e77d,,Michael,853.7,8/9/2018,M,38,Green Valley,NSW,2018-08-09T19:18:34.000+0000,10.76,c8cfc13ddc364a49b1fd916994205628,Australia,CUS-2142601169,150.87 -33.91,debit
authorized,1,,ACC-1222300524,AUD,151.23 -33.94,POS,343ea9db-c612-48e1-85c9-46bfc3311b67,,Michael,699.57,8/10/2018,M,38,Hinchinbrook,NSW,2018-08-10T04:27:29.000+0000,104.13,011dbc469fa74d2494afbb40777f0159,Australia,CUS-2142601169,150.86 -33.92,debit
authorized,0,,ACC-1222300524,AUD,151.23 -33.94,POS,84335287-a509-4a8f-836a-f71fa050bf4d,,Michael,673.76,8/10/2018,M,38,Richmond,VIC,2018-08-10T10:14:53.000+0000,25.81,c485269a6b2449fc8243fb57371caf1e,Australia,CUS-2142601169,145 -37.83,debit
authorized,1,,ACC-1222300524,AUD,151.23 -33.94,SALES-POS,a33597e2-742c-4bde-aa32-880e687454b2,,Michael,630.26,8/10/2018,M,38,Chatswood,NSW,2018-08-10T11:46:39.000+0000,43.5,1a7dab8c43b14c03aa800df0c44984de,Australia,CUS-2142601169,151.2 -33.79,debit
authorized,1,,ACC-1222300524,AUD,151.23 -33.94,SALES-POS,1d576c21-3e89-46b7-878d-042a6a982021,,Michael,624.35,8/10/2018,M,38,Mosman,NSW,2018-08-10T15:32:42.000+0000,5.91,26ce79d92335419fb32c079422889ae3,Australia,CUS-2142601169,151.24 -33.82,debit
authorized,1,,ACC-1222300524,AUD,151.23 -33.94,SALES-POS,e6d52b86-4c77-4486-b7fa-63785ef12b11,,Michael,618.31,8/10/2018,M,38,Parramatta,NSW,2018-08-10T15:54:08.000+0000,6.04,957828e8cea34138ae588bd404e445d4,Australia,CUS-2142601169,151 -33.81,debit
authorized,1,,ACC-1222300524,AUD,151.23 -33.94,SALES-POS,7b65e1b5-1a06-4ed0-9da1-56c65f7cb53d,,Michael,611.08,8/10/2018,M,38,Clinton,QLD,2018-08-10T16:02:54.000+0000,7.23,8256a3b075574f59b4f9c8a2eeb2fcfb,Australia,CUS-2142601169,151.22 -23.88,debit
authorized,1,,ACC-1222300524,AUD,151.23 -33.94,POS,aaeed7be-046d-4e82-b71f-f28911441d2e,,Michael,537.38,8/10/2018,M,38,Sydney,NSW,2018-08-10T18:13:54.000+0000,73.7,16f1a5d4033f47e2b534dd4775a96a8e,Australia,CUS-2142601169,151.21 -33.87,debit
authorized,1,,ACC-1222300524,AUD,151.23 -33.94,POS,c05793a8-011a-4cee-bb28-54127559c420,,Michael,488.25,8/10/2018,M,38,Sydney,NSW,2018-08-10T20:15:49.000+0000,49.13,507134c6c4a54b959384ad52df7c6f11,Australia,CUS-2142601169,151.21 -33.87,debit
authorized,0,,ACC-1222300524,AUD,151.23 -33.94,POS,de440092-1855-4457-9f2f-746d3a78dfcd,,Michael,477.88,8/10/2018,M,38,Wallaroo,SA,2018-08-10T22:27:36.000+0000,10.37,da9fb048881e415aac7b1f350957b35b,Australia,CUS-2142601169,137.63 -33.93,debit
authorized,1,,ACC-1222300524,AUD,151.23 -33.94,SALES-POS,174e837f-f0fb-497f-96ba-6bfd26e764cb,,Michael,470.04,8/11/2018,M,38,Neutral Bay,NSW,2018-08-11T02:24:40.000+0000,7.84,801306afd63d4362b85e2f810e00c7c6,Australia,CUS-2142601169,151.22 -33.84,debit
authorized,1,,ACC-1222300524,AUD,151.23 -33.94,POS,9fc40400-d1e4-4785-b009-711de7834ed6,,Michael,452.43,8/11/2018,M,38,Casula,NSW,2018-08-11T02:45:57.000+0000,17.61,95f27c56ccb442e6a91073fc486a13b6,Australia,CUS-2142601169,150.91 -33.95,debit
authorized,1,,ACC-1222300524,AUD,151.23 -33.94,POS,0eddf2c5-0432-4dba-afac-5bce83027625,,Michael,434.52,8/11/2018,M,38,Kingsgrove,NSW,2018-08-11T03:13:04.000+0000,17.91,1c08e303658e458ba18f91aec1084c83,Australia,CUS-2142601169,151.09 -33.94,debit
authorized,1,,ACC-1222300524,AUD,151.23 -33.94,SALES-POS,f508fb74-e9e5-4f0a-bf9f-10b00516b565,,Michael,415.63,8/11/2018,M,38,Moorebank,NSW,2018-08-11T09:52:23.000+0000,18.89,7bf89883ab704e72a5762f3bca07ff17,Australia,CUS-2142601169,150.94 -33.94,debit
authorized,1,,ACC-1222300524,AUD,151.23 -33.94,SALES-POS,240ca90a-50e6-4e42-b644-1b64daf3162e,,Michael,408.16,8/11/2018,M,38,Sydney,NSW,2018-08-11T16:55:24.000+0000,7.47,f1abb715f54441d290a649c1995d5f8a,Australia,CUS-2142601169,151.19 -33.89,debit
authorized,1,,ACC-1222300524,AUD,151.23 -33.94,POS,6714d0be-9a69-4d2c-8d45-c8fc84df9eaa,,Michael,397.01,8/11/2018,M,38,Melbourne,VIC,2018-08-11T20:15:11.000+0000,11.15,1079428f62ac4d3f92cb178fe872374a,Australia,CUS-2142601169,144.97 -37.82,debit
authorized,1,,ACC-1222300524,AUD,151.23 -33.94,POS,8f2c36dd-9a99-4230-b00f-99bbb42b68ef,,Michael,389.26,8/11/2018,M,38,Kadina,SA,2018-08-11T20:41:51.000+0000,7.75,107294959b644db4bae6a9125f7e67a5,Australia,CUS-2142601169,137.71 -33.96,debit
authorized,1,,ACC-1222300524,AUD,151.23 -33.94,POS,0240783c-8903-4a0a-bc0e-5910e9d44efb,,Michael,385.08,8/11/2018,M,38,Newtown,NSW,2018-08-11T22:33:31.000+0000,4.18,9ee6c59da0e94f458f71f79ab397faa8,Australia,CUS-2142601169,151.18 -33.9,debit
authorized,1,,ACC-1222300524,AUD,151.23 -33.94,SALES-POS,d9d425e5-747b-4dd7-8fba-c386ba9aa68b,,Michael,368.85,8/12/2018,M,38,Five Dock,NSW,2018-08-12T08:43:44.000+0000,16.23,4eef6744992d44c1b36bfe5e18e7e10d,Australia,CUS-2142601169,151.11 -33.87,debit
authorized,0,,ACC-1222300524,AUD,151.23 -33.94,SALES-POS,05f675e8-7ccb-4a5a-8d29-c92ddc222db8,,Michael,353.78,8/12/2018,M,38,Moorebank,NSW,2018-08-12T09:17:56.000+0000,15.07,653c77a7ce9d4c1aa42bfafa81fa8153,Australia,CUS-2142601169,150.95 -33.93,debit
authorized,1,,ACC-1222300524,AUD,151.23 -33.94,POS,87620d95-8b80-4280-b37f-06630416adf0,,Michael,341.7,8/12/2018,M,38,Parramatta,NSW,2018-08-12T09:38:33.000+0000,12.08,de89ca71ae054180862d6420d917488a,Australia,CUS-2142601169,151 -33.82,debit
authorized,1,,ACC-1222300524,AUD,151.23 -33.94,SALES-POS,4013a506-269f-4c00-8292-ac00faee2da2,,Michael,314.8,8/12/2018,M,38,Croydon Park,NSW,2018-08-12T09:54:01.000+0000,26.9,147924b95b7d4fa399295a189e41dd32,Australia,CUS-2142601169,151.11 -33.9,debit
authorized,1,,ACC-1222300524,AUD,151.23 -33.94,POS,f1c4fbd8-97d4-47f2-8d03-cb82f24dc169,,Michael,306.51,8/12/2018,M,38,West Gladstone,QLD,2018-08-12T12:09:03.000+0000,8.29,2084a37af8d44564ba8ef946516eb3ac,Australia,CUS-2142601169,151.24 -23.87,debit
authorized,1,,ACC-1222300524,AUD,151.23 -33.94,POS,ebf3ad3a-f6d5-48c5-bd49-a9ceb9fc0561,,Michael,295.37,8/12/2018,M,38,Lakemba,NSW,2018-08-12T13:45:59.000+0000,11.14,5619d7311fd343998dc4045dc53aafb2,Australia,CUS-2142601169,151.08 -33.92,debit
authorized,1,,ACC-1222300524,AUD,151.23 -33.94,SALES-POS,04d91fae-917e-4815-be46-c4eb87b9add7,,Michael,285.57,8/12/2018,M,38,Marrickville,NSW,2018-08-12T21:14:13.000+0000,9.8,22b4d01045ba46cd881ab4c1fe09fe74,Australia,CUS-2142601169,151.16 -33.91,debit
authorized,1,,ACC-1222300524,AUD,151.23 -33.94,SALES-POS,48b3eea8-ba57-4271-9b5d-ba3554f1b2ad,,Michael,261.98,8/12/2018,M,38,Liverpool,NSW,2018-08-12T21:33:27.000+0000,23.59,8aae79cb46834b259b688735af23e130,Australia,CUS-2142601169,150.92 -33.92,debit
authorized,0,,ACC-1222300524,AUD,151.23 -33.94,POS,5c7008d4-2b8a-4232-bcf0-b42a300f9b0f,,Michael,247.25,8/12/2018,M,38,Parramatta,NSW,2018-08-12T21:46:16.000+0000,14.73,7ae0fc57f76341ed8dfcb26f69d19d3f,Australia,CUS-2142601169,151 -33.81,debit
authorized,1,,ACC-1222300524,AUD,151.23 -33.94,POS,6ffb6914-0de5-4322-b2ad-25bfad838eb7,,Michael,245.15,8/13/2018,M,38,Lane Cove,NSW,2018-08-13T07:35:33.000+0000,2.1,fc5675fbcc0c4266ba8653726c5ddf46,Australia,CUS-2142601169,151.17 -33.81,debit
authorized,1,,ACC-1222300524,AUD,151.23 -33.94,SALES-POS,2f8d2948-0840-4110-9132-7df7e7f3ee2d,,Michael,237.74,8/13/2018,M,38,Mount Druitt,NSW,2018-08-13T09:19:28.000+0000,7.41,9fbd74096cb54732885ff136ece717b7,Australia,CUS-2142601169,150.82 -33.77,debit
authorized,1,,ACC-1222300524,AUD,151.23 -33.94,POS,356f2efa-440f-4438-ad88-9415976f58f0,,Michael,229.46,8/13/2018,M,38,Homebush West,NSW,2018-08-13T10:30:04.000+0000,8.28,f7c5f102fb5c490daa7d8eec8513b48d,Australia,CUS-2142601169,151.07 -33.87,debit
authorized,1,,ACC-1222300524,AUD,151.23 -33.94,SALES-POS,596306e9-de9d-4ebb-8309-71088dafcf1d,,Michael,130.53,8/13/2018,M,38,Bankstown,NSW,2018-08-13T13:22:26.000+0000,98.93,87e7bdc08aa9496887dc8d8796e5c708,Australia,CUS-2142601169,151.04 -33.92,debit
posted,,0,ACC-1222300524,AUD,151.23 -33.94,PAY/SALARY,,0,Michael,1132.66,8/14/2018,M,38,,,2018-08-14T17:00:00.000+0000,1002.13,6217095136fc488fa19ba8c1a716e8f9,Australia,CUS-2142601169,,credit
posted,,0,ACC-1222300524,AUD,151.23 -33.94,PAY/SALARY,,0,Michael,2084.79,8/21/2018,M,38,,,2018-08-21T17:00:00.000+0000,1002.13,033c6a989918484899e9ff3b9d066f31,Australia,CUS-2142601169,,credit
authorized,1,,ACC-1222300524,AUD,151.23 -33.94,POS,308ac76c-03d3-4de8-b593-4eec154824c3,,Michael,2077.92,8/22/2018,M,38,Belmore,NSW,2018-08-22T11:04:59.000+0000,6.87,f0ad3996412348c895563c99249256f7,Australia,CUS-2142601169,151.09 -33.92,debit
authorized,1,,ACC-1222300524,AUD,151.23 -33.94,SALES-POS,fb24053d-5522-4646-bdc7-71130114e96c,,Michael,2073.16,8/22/2018,M,38,Chatswood,NSW,2018-08-22T11:19:42.000+0000,4.76,8b25208647c543d183836220ef3d0e72,Australia,CUS-2142601169,151.18 -33.8,debit
authorized,1,,ACC-1222300524,AUD,151.23 -33.94,SALES-POS,143beac6-1608-4b52-9288-70a6b2617ad2,,Michael,1994.15,8/22/2018,M,38,Panania,NSW,2018-08-22T16:39:19.000+0000,79.01,a6d9e63d81054fe88c3867973cea6d0c,Australia,CUS-2142601169,151 -33.95,debit
authorized,1,,ACC-1222300524,AUD,151.23 -33.94,SALES-POS,63c4c62f-d976-4854-97d5-f2a83f11bdb5,,Michael,1959.18,8/22/2018,M,38,Beacon Hill,NSW,2018-08-22T19:24:32.000+0000,34.97,762140984800405cb47d30a9e7398cf3,Australia,CUS-2142601169,151.25 -33.75,debit
authorized,0,,ACC-1222300524,AUD,151.23 -33.94,SALES-POS,1f3cf107-6d54-43a9-b6be-b0a1ee2ba1da,,Michael,1937.22,8/22/2018,M,38,Liverpool,NSW,2018-08-22T20:52:13.000+0000,21.96,01b794d03d2d483a849e7f0b0207e022,Australia,CUS-2142601169,150.92 -33.92,debit
authorized,1,,ACC-1222300524,AUD,151.23 -33.94,SALES-POS,24a75e8c-8f54-465d-94a7-d3b058ee32e7,,Michael,1913.89,8/22/2018,M,38,Moorebank,NSW,2018-08-22T22:00:33.000+0000,23.33,7240db01719a4938af94bb396e4d9049,Australia,CUS-2142601169,150.96 -33.93,debit
authorized,1,,ACC-1222300524,AUD,151.23 -33.94,SALES-POS,94358d5e-9b20-4f42-b60f-db977bf8ba23,,Michael,1895.61,8/23/2018,M,38,Eastwood,NSW,2018-08-23T01:19:59.000+0000,18.28,8585c1c4ea4d4dd9aef54179f916d8fb,Australia,CUS-2142601169,151.08 -33.79,debit
authorized,0,,ACC-1222300524,AUD,151.23 -33.94,POS,a1ca1b7e-a737-4fc8-b070-3e606f52c0d6,,Michael,1887.96,8/23/2018,M,38,Margaret River,WA,2018-08-23T15:27:39.000+0000,7.65,8548d8e4aeb549478717d5651c008d7b,Australia,CUS-2142601169,115.07 -33.95,debit
authorized,1,,ACC-1222300524,AUD,151.23 -33.94,POS,eff25fdb-a677-437b-bb87-f4e4b4614499,,Michael,1868.82,8/23/2018,M,38,Bankstown,NSW,2018-08-23T18:43:48.000+0000,19.14,0908dbda136147f4992ea8f6e8980214,Australia,CUS-2142601169,151.04 -33.92,debit
posted,,,ACC-1222300524,AUD,151.23 -33.94,PAYMENT,,,Michael,1818.82,8/23/2018,M,38,,,2018-08-23T19:00:00.000+0000,50,d55089db092c45a0ba799613d6f54287,Australia,CUS-2142601169,,debit
authorized,1,,ACC-1222300524,AUD,151.23 -33.94,SALES-POS,bf5f0640-01bb-44e5-ba16-8bd356c8ce9c,,Michael,1737.93,8/23/2018,M,38,Blacktown,NSW,2018-08-23T23:36:57.000+0000,80.89,3ab068da21c84209896a9443f6bb7487,Australia,CUS-2142601169,150.91 -33.77,debit
authorized,1,,ACC-1222300524,AUD,151.23 -33.94,SALES-POS,ac64dff2-d786-44fa-a332-3f530bdd0444,,Michael,1721.63,8/24/2018,M,38,Rockdale,NSW,2018-08-24T11:01:45.000+0000,16.3,01948766d87d40b8b275de9ab0486bc3,Australia,CUS-2142601169,151.14 -33.96,debit
authorized,1,,ACC-1222300524,AUD,151.23 -33.94,SALES-POS,a9ef765f-2a48-4d8d-a08f-5cf8e5ed52c9,,Michael,1699.88,8/24/2018,M,38,Greystanes,NSW,2018-08-24T11:09:45.000+0000,21.75,5efa08581a1448eea225b306588987f8,Australia,CUS-2142601169,150.94 -33.81,debit
authorized,0,,ACC-1222300524,AUD,151.23 -33.94,SALES-POS,bfbb283f-f5a2-4b5b-b1e3-9e5edc057ae3,,Michael,1684.71,8/24/2018,M,38,Chatswood,NSW,2018-08-24T12:29:09.000+0000,15.17,0d62fbc5421740ec9dd5e68d9d5849b3,Australia,CUS-2142601169,151.18 -33.8,debit
authorized,1,,ACC-1222300524,AUD,151.23 -33.94,SALES-POS,63e318b8-783c-46f2-af70-0b0e0324e027,,Michael,1672.12,8/24/2018,M,38,Sydney,NSW,2018-08-24T23:58:37.000+0000,12.59,e58e404d30f44c44b17f78de442d2240,Australia,CUS-2142601169,151.2 -33.87,debit
authorized,1,,ACC-1222300524,AUD,151.23 -33.94,SALES-POS,518c54bf-8f28-4d8c-8c70-aacfe46d1865,,Michael,1659.52,8/25/2018,M,38,New Town,SA,2018-08-25T08:59:41.000+0000,12.6,6b74fe83067f4f4ea8e3b782146bf71c,Australia,CUS-2142601169,137.7 -33.96,debit
authorized,1,,ACC-1222300524,AUD,151.23 -33.94,SALES-POS,16e2e89f-c7ba-40b9-ba89-26d0cf5bb9fd,,Michael,1582.27,8/25/2018,M,38,Parramatta,NSW,2018-08-25T10:02:10.000+0000,77.25,97f58cd2b253439c82b43a3d566ddb61,Australia,CUS-2142601169,151 -33.82,debit
authorized,1,,ACC-1222300524,AUD,151.23 -33.94,POS,4a53422f-6e66-44ae-909f-ba93192dc76b,,Michael,1577.23,8/25/2018,M,38,Liverpool,NSW,2018-08-25T12:47:04.000+0000,5.04,20342dec499e472c9665e1f9e703b41e,Australia,CUS-2142601169,150.92 -33.92,debit
authorized,1,,ACC-1222300524,AUD,151.23 -33.94,SALES-POS,bcd0ee88-b7f0-4e27-a66a-c865787b88d2,,Michael,1568.59,8/25/2018,M,38,Liverpool,NSW,2018-08-25T14:38:09.000+0000,8.64,78be1dcac804461c95a3c824e0d983e7,Australia,CUS-2142601169,150.92 -33.92,debit
authorized,1,,ACC-1222300524,AUD,151.23 -33.94,POS,4d4a87fc-a840-450f-ac8d-d96c7bc5ec31,,Michael,1530.91,8/25/2018,M,38,Macquarie Park,NSW,2018-08-25T17:14:43.000+0000,37.68,90e5af37ecc04a2998cfa59109f4c4fd,Australia,CUS-2142601169,151.13 -33.79,debit
authorized,1,,ACC-1222300524,AUD,151.23 -33.94,SALES-POS,96828216-c471-47f3-b14b-e25f78f32c79,,Michael,1516,8/26/2018,M,38,Penshurst,NSW,2018-08-26T10:12:08.000+0000,14.91,09fd47bdd6214188b7d8849a66f69d5d,Australia,CUS-2142601169,151.08 -33.96,debit
authorized,0,,ACC-1222300524,AUD,151.23 -33.94,POS,77d5548f-16a1-4821-a564-bed19ba18f24,,Michael,1508.35,8/26/2018,M,38,Len Waters Estate,NSW,2018-08-26T10:40:42.000+0000,7.65,6bfe43b0ebaa440ca139bc03645dbb3b,Australia,CUS-2142601169,150.86 -33.92,debit
authorized,1,,ACC-1222300524,AUD,151.23 -33.94,SALES-POS,805e2d12-0bb1-44ca-bf7f-ede7377f09db,,Michael,1496.39,8/26/2018,M,38,Brookvale,NSW,2018-08-26T12:06:09.000+0000,11.96,751bdae27b0b4047a2dc700f5a82046f,Australia,CUS-2142601169,151.26 -33.77,debit
authorized,1,,ACC-1222300524,AUD,151.23 -33.94,SALES-POS,a1563cc9-1efa-430f-808c-b7236e129749,,Michael,1486.34,8/26/2018,M,38,Hart,SA,2018-08-26T13:23:59.000+0000,10.05,dfdbf658ccee4055bec7d7a24c370c20,Australia,CUS-2142601169,138.44 -33.76,debit
authorized,1,,ACC-1222300524,AUD,151.23 -33.94,SALES-POS,1c4d189b-15f8-4e6a-bf26-8c6e59804408,,Michael,1478.77,8/26/2018,M,38,Millmerran,QLD,2018-08-26T21:30:47.000+0000,7.57,8068326c95bb4a7b8c61875d89c4c0b5,Australia,CUS-2142601169,151.27 -27.88,debit
authorized,1,,ACC-1222300524,AUD,151.23 -33.94,SALES-POS,9d51aada-0f7e-4664-aa5d-6119a888f759,,Michael,1396.82,8/26/2018,M,38,Sydney,NSW,2018-08-26T22:18:47.000+0000,81.95,289cf8f03a5b4406b573b753ac902640,Australia,CUS-2142601169,151.21 -33.87,debit
authorized,1,,ACC-1222300524,AUD,151.23 -33.94,SALES-POS,4b70e3d4-96ca-407d-ab8a-f5c54c0b6036,,Michael,1373.52,8/27/2018,M,38,Liverpool,NSW,2018-08-27T10:18:36.000+0000,23.3,7eacc797b1d34cb08f53492cb110c816,Australia,CUS-2142601169,150.92 -33.93,debit
authorized,0,,ACC-1222300524,AUD,151.23 -33.94,SALES-POS,438fdb3a-9c2c-45ac-9583-f138420f0d18,,Michael,1348.13,8/27/2018,M,38,Kadina,SA,2018-08-27T21:22:47.000+0000,25.39,5ddd1374fc5f4e2eb4a97383aa09d454,Australia,CUS-2142601169,137.72 -33.96,debit
authorized,1,,ACC-1222300524,AUD,151.23 -33.94,POS,ff07af80-5a16-4b43-9ce9-d471b3d0daf1,,Michael,1333.37,8/28/2018,M,38,Sydney,NSW,2018-08-28T04:22:39.000+0000,14.76,ead1aee7f61044e88498bdc7debdedce,Australia,CUS-2142601169,151.08 -33.93,debit
authorized,1,,ACC-1222300524,AUD,151.23 -33.94,SALES-POS,8ca8ce61-1e0b-4bac-80ba-201190896c37,,Michael,1327.43,8/28/2018,M,38,Revesby,NSW,2018-08-28T09:08:18.000+0000,5.94,8bbd142e488d42309534d4e32b3f707a,Australia,CUS-2142601169,151.02 -33.95,debit
authorized,1,,ACC-1222300524,AUD,151.23 -33.94,POS,eff24725-7bf4-4609-b729-a5cb67288f3d,,Michael,1302.84,8/28/2018,M,38,Padstow,NSW,2018-08-28T09:44:35.000+0000,24.59,3d457495dab3465ab85fc2096489e9bf,Australia,CUS-2142601169,151.04 -33.94,debit
authorized,1,,ACC-1222300524,AUD,151.23 -33.94,POS,d7cf976a-7c9c-453a-9fdf-ece9ecb9a484,,Michael,1277.5,8/28/2018,M,38,Clinton,QLD,2018-08-28T11:01:02.000+0000,25.34,0220f94ae71c43ecbdb336064ba5f951,Australia,CUS-2142601169,151.22 -23.88,debit
posted,,0,ACC-1222300524,AUD,151.23 -33.94,PAY/SALARY,,0,Michael,2279.63,8/28/2018,M,38,,,2018-08-28T17:00:00.000+0000,1002.13,c313c9506ec44e8e80ca038c42b45d5f,Australia,CUS-2142601169,,credit
authorized,1,,ACC-1222300524,AUD,151.23 -33.94,POS,79b9f09f-73fd-4bae-a1b9-0f8e13358b4c,,Michael,2267.3,8/29/2018,M,38,Pyrmont,NSW,2018-08-29T14:46:16.000+0000,12.33,b85c8fbfa55f416c8cda751ae9dec695,Australia,CUS-2142601169,151.2 -33.87,debit
authorized,0,,ACC-1222300524,AUD,151.23 -33.94,SALES-POS,0ee8697e-18ad-41b7-a285-4973c6634982,,Michael,2250.25,8/29/2018,M,38,Cambridge Park,NSW,2018-08-29T15:14:09.000+0000,17.05,9a0fdc174139484f97c469709ebf7a2b,Australia,CUS-2142601169,150.72 -33.75,debit
authorized,1,,ACC-1222300524,AUD,151.23 -33.94,POS,3ce2653e-5bde-4459-9aef-af93e8ebaf1c,,Michael,2242.15,8/29/2018,M,38,North Sydney,NSW,2018-08-29T15:37:58.000+0000,8.1,6955ba8efb2d416a9f8921bd4fe4ece3,Australia,CUS-2142601169,151.21 -33.84,debit
authorized,0,,ACC-1222300524,AUD,151.23 -33.94,SALES-POS,4c7213c1-8e71-4c8a-917f-cea08a5cf4db,,Michael,2214.8,8/30/2018,M,38,Lurnea,NSW,2018-08-30T15:03:04.000+0000,27.35,8fbc2ea160364e93a08e8d5d8854033b,Australia,CUS-2142601169,150.9 -33.93,debit
authorized,1,,ACC-1222300524,AUD,151.23 -33.94,SALES-POS,658fbab9-3626-4516-9ad0-d4fc2e7eafbc,,Michael,2210.63,8/30/2018,M,38,Punchbowl,NSW,2018-08-30T15:34:48.000+0000,4.17,83d9d4b9d63b42f39cd5c59e2d469327,Australia,CUS-2142601169,151.04 -33.93,debit
authorized,1,,ACC-1222300524,AUD,151.23 -33.94,POS,abe64210-3df3-4615-83d7-5cc2c28964d6,,Michael,2197.34,8/30/2018,M,38,Ultimo,NSW,2018-08-30T15:40:06.000+0000,13.29,b466499527744863bd4ecd461c3acbdf,Australia,CUS-2142601169,151.2 -33.88,debit
authorized,1,,ACC-1222300524,AUD,151.23 -33.94,SALES-POS,6f483fb2-c860-4d75-8c48-846fd9ce5500,,Michael,2175,8/30/2018,M,38,Emu Plains,NSW,2018-08-30T16:11:16.000+0000,22.34,90de06607ab2415d88202218dbb8441c,Australia,CUS-2142601169,150.66 -33.75,debit
authorized,1,,ACC-1222300524,AUD,151.23 -33.94,SALES-POS,3075b265-3b29-4d54-a38e-c379113f73bf,,Michael,2082.12,8/30/2018,M,38,Balingup,WA,2018-08-30T17:07:31.000+0000,92.88,1f3dcc274d3944e5939f41499416a3b3,Australia,CUS-2142601169,115.97 -33.79,debit
authorized,1,,ACC-1222300524,AUD,151.23 -33.94,POS,134b1580-cc99-4261-992d-8aef5b5b1375,,Michael,2072.55,8/30/2018,M,38,Westmead,NSW,2018-08-30T17:19:17.000+0000,9.57,35d21ae2ed334b7481b106eeb1b48cf1,Australia,CUS-2142601169,150.99 -33.81,debit
posted,,,ACC-1222300524,AUD,151.23 -33.94,PAYMENT,,,Michael,2022.55,8/30/2018,M,38,,,2018-08-30T19:00:00.000+0000,50,b8c8649704f740a1a800028b020ff18e,Australia,CUS-2142601169,,debit
authorized,0,,ACC-1222300524,AUD,151.23 -33.94,SALES-POS,a992af86-06b6-48e4-a951-ec1ceb529957,,Michael,2005.24,8/30/2018,M,38,Peakhurst,NSW,2018-08-30T21:55:11.000+0000,17.31,c971e3dc8c554cd796a7bbc1373125ec,Australia,CUS-2142601169,151.06 -33.96,debit
authorized,0,,ACC-1222300524,AUD,151.23 -33.94,POS,1e48b1a9-5fe2-408f-92f2-1b0406edb2c8,,Michael,2001.99,8/30/2018,M,38,Mortdale,NSW,2018-08-30T23:39:59.000+0000,3.25,2ac6a76a7550494eaec0fa87d1f33b91,Australia,CUS-2142601169,151.08 -33.97,debit
authorized,1,,ACC-1222300524,AUD,151.23 -33.94,POS,31dfa493-202d-4c6f-93c6-a4722c1fc92f,,Michael,1951.1,8/31/2018,M,38,Sydney,NSW,2018-08-31T01:57:35.000+0000,50.89,364a88067bfb44a3947e46e9c54b26df,Australia,CUS-2142601169,151.2 -33.87,debit
authorized,1,,ACC-1222300524,AUD,151.23 -33.94,POS,68b25786-f854-4deb-9e9b-bc3e11217907,,Michael,1943.73,8/31/2018,M,38,Westmead,NSW,2018-08-31T08:07:35.000+0000,7.37,e1e04ae854ff44d8b9d8e3a26224d948,Australia,CUS-2142601169,150.99 -33.81,debit
authorized,1,,ACC-1222300524,AUD,151.23 -33.94,SALES-POS,fce3c46f-5fa7-47aa-a50a-7b12ad1644b8,,Michael,1933.66,9/1/2018,M,38,Roselands,NSW,2018-09-01T15:10:17.000+0000,10.07,1f67543070b54735aa156b3a7476510d,Australia,CUS-2142601169,151.07 -33.93,debit
authorized,1,,ACC-1222300524,AUD,151.23 -33.94,SALES-POS,5bef6f4d-3555-4b95-9419-bb8816864048,,Michael,1924.92,9/1/2018,M,38,Ashburton,VIC,2018-09-01T16:29:22.000+0000,8.74,2085c18ea33c4a06aab92fff65045894,Australia,CUS-2142601169,145.09 -37.86,debit
authorized,0,,ACC-1222300524,AUD,151.23 -33.94,POS,14dceb58-aa1a-4fa3-9633-e359b7247c0b,,Michael,1907.97,9/1/2018,M,38,Five Dock,NSW,2018-09-01T17:08:23.000+0000,16.95,063fba39c72b46ab853c9d9359cb8132,Australia,CUS-2142601169,151.11 -33.87,debit
authorized,1,,ACC-1222300524,AUD,151.23 -33.94,POS,81c98cac-899b-4aea-b50b-8382e706a5ad,,Michael,1901.53,9/2/2018,M,38,Bankstown,NSW,2018-09-02T10:28:46.000+0000,6.44,a4c274a24ac144ea9488b737607fc4ec,Australia,CUS-2142601169,151.04 -33.92,debit
authorized,1,,ACC-1222300524,AUD,151.23 -33.94,SALES-POS,5cf787f7-83e4-4354-bae2-05be0334d290,,Michael,1855.51,9/2/2018,M,38,Eagle Farm,QLD,2018-09-02T13:40:22.000+0000,46.02,bbd610a2571b4299a0efdb9f48f54791,Australia,CUS-2142601169,153.08 -27.41,debit
authorized,1,,ACC-1222300524,AUD,151.23 -33.94,SALES-POS,7747bd2b-e29e-486f-b6aa-ad20ec5f6971,,Michael,1834.58,9/2/2018,M,38,Bankstown,NSW,2018-09-02T13:58:53.000+0000,20.93,152da5aedd6f4a96a43db48e0af96f64,Australia,CUS-2142601169,151.04 -33.92,debit
posted,,,ACC-1222300524,AUD,151.23 -33.94,PAYMENT,,,Michael,1732.58,9/2/2018,M,38,,,2018-09-02T23:00:00.000+0000,102,7f82031ee2674ddea7ed3da4b8ee1dac,Australia,CUS-2142601169,,debit
authorized,1,,ACC-1222300524,AUD,151.23 -33.94,POS,7aa35faa-c607-489f-b7ea-226b095b16ee,,Michael,1652.07,9/3/2018,M,38,Melbourne,VIC,2018-09-03T08:29:50.000+0000,80.51,bd12331fd9734731a8f876985492c0ba,Australia,CUS-2142601169,144.96 -37.82,debit
authorized,1,,ACC-1222300524,AUD,151.23 -33.94,POS,bcd0ee88-b7f0-4e27-a66a-c865787b88d2,,Michael,1646.26,9/3/2018,M,38,Liverpool,NSW,2018-09-03T15:26:23.000+0000,5.81,34d064aed5e241f79c8ec44c03657e22,Australia,CUS-2142601169,150.92 -33.92,debit
authorized,1,,ACC-1222300524,AUD,151.23 -33.94,POS,c791c707-2472-4ac0-9fa1-33a47d2b608b,,Michael,1641.73,9/3/2018,M,38,Berala,NSW,2018-09-03T17:36:14.000+0000,4.53,e00d79fa67fa429bb52597ec7ee1bf19,Australia,CUS-2142601169,151.03 -33.87,debit
authorized,1,,ACC-1222300524,AUD,151.23 -33.94,SALES-POS,9d51aada-0f7e-4664-aa5d-6119a888f759,,Michael,1558.67,9/4/2018,M,38,Sydney,NSW,2018-09-04T11:41:52.000+0000,83.06,4a3b335076e34ea0a89be27ab096aa1b,Australia,CUS-2142601169,151.21 -33.87,debit
authorized,1,,ACC-1222300524,AUD,151.23 -33.94,POS,f2c76ff1-b59a-4739-8e40-fa5cde1289c5,,Michael,1543.26,9/4/2018,M,38,South Hurstville,NSW,2018-09-04T13:34:46.000+0000,15.41,144796a769c045399c7ff3f7a57ec9e4,Australia,CUS-2142601169,151.11 -33.98,debit
authorized,1,,ACC-1222300524,AUD,151.23 -33.94,POS,e87637aa-6498-48b3-ac58-0725fb7c60a0,,Michael,1533.59,9/4/2018,M,38,Penrith,NSW,2018-09-04T14:39:35.000+0000,9.67,f12f08beb0ed4c57bac4b543b52c6b06,Australia,CUS-2142601169,150.69 -33.75,debit
posted,,0,ACC-1222300524,AUD,151.23 -33.94,PAY/SALARY,,0,Michael,2535.72,9/4/2018,M,38,,,2018-09-04T17:00:00.000+0000,1002.13,55f30325fb894bb8896e4fc6c6d9ecf8,Australia,CUS-2142601169,,credit
authorized,1,,ACC-1222300524,AUD,151.23 -33.94,POS,e5b2b589-812a-44a1-a1bb-403d9ee9a1b4,,Michael,186.17,9/5/2018,M,38,Mascot,NSW,2018-09-05T09:01:09.000+0000,2349.55,e9d3f4a032944711b58ba0eba4c4c33b,Australia,CUS-2142601169,151.17 -33.94,debit
authorized,1,,ACC-1222300524,AUD,151.23 -33.94,SALES-POS,09f289b2-6d59-4325-b710-689496f66c77,,Michael,181.13,9/5/2018,M,38,Williamstown North,VIC,2018-09-05T16:06:26.000+0000,5.04,fe77129bbf1d43c5b59ead41a13b8f76,Australia,CUS-2142601169,144.86 -37.85,debit
authorized,1,,ACC-1222300524,AUD,151.23 -33.94,POS,86d8554a-921c-4369-84b6-e347b16e92a7,,Michael,165.91,9/5/2018,M,38,Lakemba,NSW,2018-09-05T22:15:37.000+0000,15.22,7108b13d83fe4d8aa8460d7423506bd5,Australia,CUS-2142601169,151.08 -33.92,debit
authorized,1,,ACC-1222300524,AUD,151.23 -33.94,POS,9690a753-fe1a-4bfd-be12-5b33652e8093,,Michael,120.84,9/6/2018,M,38,Penrith,NSW,2018-09-06T09:05:52.000+0000,45.07,4aed7e3896344514a1513fe0a876e65e,Australia,CUS-2142601169,150.69 -33.75,debit
posted,,,ACC-1222300524,AUD,151.23 -33.94,PAYMENT,,,Michael,70.84,9/6/2018,M,38,,,2018-09-06T19:00:00.000+0000,50,5e4b77f981b649939c877b524ba3867a,Australia,CUS-2142601169,,debit
authorized,1,,ACC-1222300524,AUD,151.23 -33.94,SALES-POS,bd55b2be-eda5-45e8-8a91-053eafbd5480,,Michael,64.13,9/7/2018,M,38,Bridgetown,WA,2018-09-07T12:06:33.000+0000,6.71,fe6986c1f84c4e399deacedddd992d79,Australia,CUS-2142601169,116.14 -33.96,debit
authorized,0,,ACC-1222300524,AUD,151.23 -33.94,SALES-POS,0b4b5cb5-ced8-443e-b4ff-b472bdf7fe88,,Michael,49.41,9/7/2018,M,38,Dee Why,NSW,2018-09-07T13:52:43.000+0000,14.72,4ec59652ed694deea2628e1c2e29be1d,Australia,CUS-2142601169,151.28 -33.75,debit
authorized,1,,ACC-1222300524,AUD,151.23 -33.94,SALES-POS,3c794012-c383-4f54-9ecf-7bff64e564ce,,Michael,32.84,9/7/2018,M,38,Metricup,WA,2018-09-07T17:40:38.000+0000,16.57,7677693654504fd3ad2d35df50d0adb1,Australia,CUS-2142601169,115.12 -33.81,debit
authorized,1,,ACC-1222300524,AUD,151.23 -33.94,SALES-POS,bc1d521f-0e20-483f-84b1-0462893ab4e9,,Michael,28.09,9/8/2018,M,38,Miller,NSW,2018-09-08T13:25:21.000+0000,4.75,6783e619d7ee435288d19acc86fcaf19,Australia,CUS-2142601169,150.88 -33.92,debit
authorized,0,,ACC-1222300524,AUD,151.23 -33.94,POS,55295baa-7aa8-4c67-bebe-ea99985be37c,,Michael,19.23,9/8/2018,M,38,Liverpool,NSW,2018-09-08T16:06:33.000+0000,8.86,c2ba589da66245a1bfe35e08142f51d4,Australia,CUS-2142601169,150.92 -33.92,debit
authorized,1,,ACC-1222300524,AUD,151.23 -33.94,POS,6ad3211d-0c5e-46a7-b768-a094d85fe5cf,,Michael,4.2,9/9/2018,M,38,Punchbowl,NSW,2018-09-09T10:27:07.000+0000,15.03,62828bcb045049008873f34677c24cc7,Australia,CUS-2142601169,151.06 -33.93,debit
posted,,0,ACC-1222300524,AUD,151.23 -33.94,PAY/SALARY,,0,Michael,1006.33,9/11/2018,M,38,,,2018-09-11T17:00:00.000+0000,1002.13,a482d73773854d24a97ad042ef265852,Australia,CUS-2142601169,,credit
authorized,0,,ACC-1222300524,AUD,151.23 -33.94,POS,b086c009-8b97-4706-b6f9-bcde403a3f49,,Michael,997.22,9/12/2018,M,38,Marrickville,NSW,2018-09-12T09:47:33.000+0000,9.11,d695060a9d5942a086a19d2d531aac04,Australia,CUS-2142601169,151.17 -33.91,debit
authorized,1,,ACC-1222300524,AUD,151.23 -33.94,SALES-POS,ac3990bf-7638-42d6-b442-da11826fb40d,,Michael,990.83,9/12/2018,M,38,Liverpool,NSW,2018-09-12T15:41:46.000+0000,6.39,8d1e8aad7bc04d2488512783a576dec8,Australia,CUS-2142601169,150.92 -33.92,debit
authorized,1,,ACC-1222300524,AUD,151.23 -33.94,SALES-POS,f656c191-9b37-4ca9-9b91-4f91ebed5cbe,,Michael,959.03,9/12/2018,M,38,Alexandria,NSW,2018-09-12T17:38:56.000+0000,31.8,06ab051a128b4718a2bf32a0db35f578,Australia,CUS-2142601169,151.19 -33.91,debit
authorized,0,,ACC-1222300524,AUD,151.23 -33.94,POS,2c5f2074-e8cc-4e01-ac39-30fd936dd547,,Michael,940.53,9/12/2018,M,38,Chatswood,NSW,2018-09-12T18:37:50.000+0000,18.5,2e3b485aa4754a6a94f5e79fdb2ae58c,Australia,CUS-2142601169,151.18 -33.8,debit
authorized,0,,ACC-1222300524,AUD,151.23 -33.94,SALES-POS,ca504361-fa5f-4c0a-a6f5-800343d80b98,,Michael,924.19,9/13/2018,M,38,Brighton-Le-Sands,NSW,2018-09-13T09:05:45.000+0000,16.34,8c538f41fddc4577b73ff14ca5e72a1e,Australia,CUS-2142601169,151.16 -33.96,debit
authorized,1,,ACC-1222300524,AUD,151.23 -33.94,POS,72cdcf17-312b-49c3-9fbe-bd3cdcf97d42,,Michael,916.81,9/13/2018,M,38,West Melbourne,VIC,2018-09-13T09:42:47.000+0000,7.38,564a561b680f437892edde0c40eb41ef,Australia,CUS-2142601169,144.95 -37.81,debit
authorized,0,,ACC-1222300524,AUD,151.23 -33.94,POS,a1ca1b7e-a737-4fc8-b070-3e606f52c0d6,,Michael,908.68,9/13/2018,M,38,Margaret River,WA,2018-09-13T10:40:26.000+0000,8.13,c5d7f8293a3e4928ac155cc9fba1f5aa,Australia,CUS-2142601169,115.07 -33.95,debit
authorized,1,,ACC-1222300524,AUD,151.23 -33.94,POS,a1082d97-f4c7-4fbd-85c6-271112d5b94d,,Michael,889.06,9/13/2018,M,38,Padstow,NSW,2018-09-13T11:09:44.000+0000,19.62,de57028c22554d798727bbe0e7ea82d1,Australia,CUS-2142601169,151.03 -33.95,debit
authorized,1,,ACC-1222300524,AUD,151.23 -33.94,POS,296a0500-8552-48ac-ac81-ec37065b568e,,Michael,845.21,9/13/2018,M,38,Casula,NSW,2018-09-13T11:35:49.000+0000,43.85,727c305e1c904251812e4a71d5c66184,Australia,CUS-2142601169,150.88 -33.96,debit
posted,,,ACC-1222300524,AUD,151.23 -33.94,PAYMENT,,,Michael,795.21,9/13/2018,M,38,,,2018-09-13T19:00:00.000+0000,50,f7ab1f65221a4e7f80d030fe37707bff,Australia,CUS-2142601169,,debit
authorized,1,,ACC-1222300524,AUD,151.23 -33.94,POS,f3c3b9e2-0600-4e15-9ca5-d1c901744c37,,Michael,781.17,9/14/2018,M,38,Northmead,NSW,2018-09-14T07:23:42.000+0000,14.04,2e20c76f166b40b0952b6a7e7415a4eb,Australia,CUS-2142601169,151 -33.79,debit
authorized,1,,ACC-1222300524,AUD,151.23 -33.94,POS,06fc4a45-fc32-4940-85a3-4e5c414c40ee,,Michael,754.28,9/14/2018,M,38,Baulkham Hills,NSW,2018-09-14T09:55:39.000+0000,26.89,7898fc7977e04a45b35ccb2b4c9c2930,Australia,CUS-2142601169,150.98 -33.75,debit
authorized,1,,ACC-1222300524,AUD,151.23 -33.94,POS,8fcf9ffb-8c03-47ef-a976-b579343f2afb,,Michael,6.45,9/14/2018,M,38,Mount Pritchard,NSW,2018-09-14T14:30:10.000+0000,747.83,5ca70dc81ce9417bb8a02708eeff4985,Australia,CUS-2142601169,150.9 -33.9,debit
authorized,1,,ACC-1222300524,AUD,151.23 -33.94,SALES-POS,a1ca1b7e-a737-4fc8-b070-3e606f52c0d6,,Michael,0.98,9/14/2018,M,38,Margaret River,WA,2018-09-14T20:08:54.000+0000,5.47,2fc1fc588217444aa9c03a070f94512c,Australia,CUS-2142601169,115.07 -33.95,debit
posted,,0,ACC-1222300524,AUD,151.23 -33.94,PAY/SALARY,,0,Michael,1003.11,9/18/2018,M,38,,,2018-09-18T17:00:00.000+0000,1002.13,08767d7901cd4688978d2cf2fb03f55a,Australia,CUS-2142601169,,credit
authorized,0,,ACC-1222300524,AUD,151.23 -33.94,SALES-POS,1bbee098-5421-4236-961f-b93cf7a1c1e6,,Michael,979.51,9/18/2018,M,38,Padstow,NSW,2018-09-18T21:08:34.000+0000,23.6,26d0948314b246ee826f5abec3aaa0ab,Australia,CUS-2142601169,151.04 -33.95,debit
authorized,1,,ACC-1222300524,AUD,151.23 -33.94,POS,65633340-2daa-4ef9-9592-0a4194581db1,,Michael,958.76,9/18/2018,M,38,Granville,NSW,2018-09-18T21:28:58.000+0000,20.75,b8f2156add994181b06864b13a055f5d,Australia,CUS-2142601169,151.01 -33.84,debit
authorized,1,,ACC-1222300524,AUD,151.23 -33.94,POS,58e9515d-2cdf-4f69-94d7-47d9fbf54e7a,,Michael,901.77,9/19/2018,M,38,Mascot,NSW,2018-09-19T06:39:59.000+0000,56.99,26baff56846244a591c512654dd01813,Australia,CUS-2142601169,151.18 -33.92,debit
authorized,0,,ACC-1222300524,AUD,151.23 -33.94,SALES-POS,4d67f493-f181-4480-be5e-215c36812157,,Michael,891.28,9/19/2018,M,38,Green Valley,NSW,2018-09-19T08:28:32.000+0000,10.49,40a7003b8ac34aa39994f85ced99683e,Australia,CUS-2142601169,150.87 -33.91,debit
authorized,1,,ACC-1222300524,AUD,151.23 -33.94,SALES-POS,6d74ef2f-57b5-4c6b-93a3-bbd3bb7ab8e4,,Michael,872.1,9/19/2018,M,38,Mortdale,NSW,2018-09-19T08:54:11.000+0000,19.18,81425b5b39c142698b3fa3cdb4ad4edf,Australia,CUS-2142601169,151.08 -33.97,debit
authorized,1,,ACC-1222300524,AUD,151.23 -33.94,POS,d1c66cfe-1569-4918-bbb2-ca9f76a14e08,,Michael,863.01,9/19/2018,M,38,Sydney,NSW,2018-09-19T09:44:29.000+0000,9.09,e0da5a8c65914910a9718b9d245891b4,Australia,CUS-2142601169,151.2 -33.87,debit
authorized,0,,ACC-1222300524,AUD,151.23 -33.94,SALES-POS,0bbb6cf4-2b52-40d2-87bc-260688679d24,,Michael,855.13,9/19/2018,M,38,Blacktown,NSW,2018-09-19T11:20:59.000+0000,7.88,95c793308d434f8c8f6d11a62b83931e,Australia,CUS-2142601169,150.91 -33.77,debit
authorized,1,,ACC-1222300524,AUD,151.23 -33.94,SALES-POS,ab7309b7-ad87-4d24-bd87-111c70b56759,,Michael,831.93,9/19/2018,M,38,Melbourne,VIC,2018-09-19T12:31:51.000+0000,23.2,4551fc93f60f4b1b907f781ed8912c41,Australia,CUS-2142601169,144.97 -37.84,debit
authorized,1,,ACC-1222300524,AUD,151.23 -33.94,POS,f3419ce8-536c-4dcf-9d0c-12c9aed8c55c,,Michael,824.52,9/19/2018,M,38,Bankstown,NSW,2018-09-19T19:20:14.000+0000,7.41,5a4d632dab194a8f84148d0242471422,Australia,CUS-2142601169,151.04 -33.92,debit
authorized,1,,ACC-1222300524,AUD,151.23 -33.94,SALES-POS,1827d393-4034-4c80-88a5-1cd6ac9deddd,,Michael,816.63,9/19/2018,M,38,Baulkham Hills,NSW,2018-09-19T20:48:19.000+0000,7.89,a2f108166f2e405d8e5bdd14e26b92a2,Australia,CUS-2142601169,150.99 -33.76,debit
authorized,1,,ACC-1222300524,AUD,151.23 -33.94,POS,8732ce7a-f43b-4402-aa94-0583c1d5e0ed,,Michael,811.09,9/19/2018,M,38,Castle Hill,NSW,2018-09-19T21:13:48.000+0000,5.54,d12d6d2c8b9345308a6aad4620dfa0a8,Australia,CUS-2142601169,151.01 -33.73,debit
authorized,0,,ACC-1222300524,AUD,151.23 -33.94,POS,d3624e41-20b8-4226-a0b6-af6adb623309,,Michael,795.13,9/20/2018,M,38,Kogarah,NSW,2018-09-20T11:54:44.000+0000,15.96,142dcfdda9c44df4a6a43d8e654671dc,Australia,CUS-2142601169,151.13 -33.97,debit
authorized,1,,ACC-1222300524,AUD,151.23 -33.94,SALES-POS,c3c23f78-96e5-4742-af04-e90764e601de,,Michael,779.12,9/20/2018,M,38,Roselands,NSW,2018-09-20T12:07:16.000+0000,16.01,81d6a5a8898344acb0be94207a0cb4ae,Australia,CUS-2142601169,151.07 -33.94,debit
authorized,1,,ACC-1222300524,AUD,151.23 -33.94,POS,ac5da399-3ad5-40b0-928c-040c6d2852f6,,Michael,769.03,9/20/2018,M,38,Liverpool,NSW,2018-09-20T15:27:58.000+0000,10.09,dd985b32ca4c4e13a67dfa4f7095aa47,Australia,CUS-2142601169,150.92 -33.92,debit
authorized,1,,ACC-1222300524,AUD,151.23 -33.94,POS,7ba901bb-74a6-4f92-a67b-09910a832a30,,Michael,753.05,9/20/2018,M,38,Arncliffe,NSW,2018-09-20T15:49:42.000+0000,15.98,ab055a402ba040fea4df3cce66bd1c4d,Australia,CUS-2142601169,151.14 -33.94,debit
authorized,1,,ACC-1222300524,AUD,151.23 -33.94,SALES-POS,d104c46f-5796-49c9-a5cd-4086bf4b04b8,,Michael,746.81,9/20/2018,M,38,Hurstville,NSW,2018-09-20T17:42:53.000+0000,6.24,0da5868fa1394beb917ac4885f93c791,Australia,CUS-2142601169,151.1 -33.97,debit
posted,,,ACC-1222300524,AUD,151.23 -33.94,PAYMENT,,,Michael,685.2,9/20/2018,M,38,,,2018-09-20T19:00:00.000+0000,50,e93bad8a8ee44326bf2286b05072a97d,Australia,CUS-2142601169,,debit
authorized,0,,ACC-1222300524,AUD,151.23 -33.94,POS,518c54bf-8f28-4d8c-8c70-aacfe46d1865,,Michael,735.2,9/20/2018,M,38,New Town,SA,2018-09-20T19:40:25.000+0000,11.61,e64f661231ca456d8f3cfe117f9b57e7,Australia,CUS-2142601169,137.7 -33.96,debit
authorized,1,,ACC-1222300524,AUD,151.23 -33.94,SALES-POS,3de8133f-edc1-4361-9e29-9d56c03f46a1,,Michael,679.94,9/21/2018,M,38,Lakemba,NSW,2018-09-21T03:47:59.000+0000,5.26,4a5ea4538f124f6daddf3c6aee673ea7,Australia,CUS-2142601169,151.08 -33.92,debit
authorized,1,,ACC-1222300524,AUD,151.23 -33.94,POS,383acd24-6920-4f3f-89ec-28f47e5f09c3,,Michael,654.61,9/21/2018,M,38,Eastgardens,NSW,2018-09-21T05:57:29.000+0000,25.33,906ad9e17c1840bd8a8694e3695c0013,Australia,CUS-2142601169,151.23 -33.95,debit
authorized,1,,ACC-1222300524,AUD,151.23 -33.94,POS,4f031f12-e88a-464b-bfe5-ceb5695d753b,,Michael,604.76,9/21/2018,M,38,Alexandria,NSW,2018-09-21T09:49:46.000+0000,49.85,c9396668aa664836a0f9a6e9591f5aa3,Australia,CUS-2142601169,151.2 -33.92,debit
authorized,1,,ACC-1222300524,AUD,151.23 -33.94,SALES-POS,69092272-47e1-4a35-9dcc-683f750cb571,,Michael,541.24,9/21/2018,M,38,Bass Hill,NSW,2018-09-21T11:13:17.000+0000,63.52,cf46626499654e8ea3465549d58f789b,Australia,CUS-2142601169,150.99 -33.9,debit
authorized,1,,ACC-1222300524,AUD,151.23 -33.94,SALES-POS,d4acd296-f531-4576-8fdd-e91a92a7ff44,,Michael,465.99,9/21/2018,M,38,Sydney,NSW,2018-09-21T14:53:23.000+0000,75.25,b662ca4dccaf4829a42767167657971b,Australia,CUS-2142601169,151.21 -33.87,debit
authorized,1,,ACC-1222300524,AUD,151.23 -33.94,POS,146cffd0-87c3-47e3-b0f3-815483a532b9,,Michael,447.83,9/21/2018,M,38,Kadina,SA,2018-09-21T17:02:14.000+0000,18.16,0c56df540ced469e9ff9a79024fa93f9,Australia,CUS-2142601169,137.71 -33.96,debit
authorized,0,,ACC-1222300524,AUD,151.23 -33.94,POS,b5a3852f-4c2c-4de8-8d06-5f3d5b76c45c,,Michael,437.65,9/21/2018,M,38,Mascot,NSW,2018-09-21T18:06:22.000+0000,10.18,a46dc580953d4a24a4f4db348a43ee30,Australia,CUS-2142601169,151.18 -33.93,debit
authorized,1,,ACC-1222300524,AUD,151.23 -33.94,POS,438fdb3a-9c2c-45ac-9583-f138420f0d18,,Michael,414.14,9/22/2018,M,38,Kadina,SA,2018-09-22T08:42:16.000+0000,23.51,82c1c0f97dc14f379603f66570d661dd,Australia,CUS-2142601169,137.72 -33.96,debit
authorized,1,,ACC-1222300524,AUD,151.23 -33.94,POS,de440092-1855-4457-9f2f-746d3a78dfcd,,Michael,403.56,9/22/2018,M,38,Wallaroo,SA,2018-09-22T09:08:31.000+0000,10.58,777e535139af4cf4b1a76e49404796d2,Australia,CUS-2142601169,137.63 -33.93,debit
authorized,0,,ACC-1222300524,AUD,151.23 -33.94,POS,0de75523-e772-4706-bd59-350afa6d3907,,Michael,390.11,9/22/2018,M,38,Manly,NSW,2018-09-22T09:22:31.000+0000,13.45,c4061641066c4e3491da0d75a1f6fd02,Australia,CUS-2142601169,151.29 -33.8,debit
authorized,1,,ACC-1222300524,AUD,151.23 -33.94,SALES-POS,c413a9a5-efe0-4b77-9138-af5afd0fa758,,Michael,378.87,9/22/2018,M,38,Camperdown,NSW,2018-09-22T09:57:28.000+0000,11.24,23f8ca1a2ce248738a30df71386e6171,Australia,CUS-2142601169,151.18 -33.89,debit
authorized,1,,ACC-1222300524,AUD,151.23 -33.94,SALES-POS,d5e0405e-956b-429c-bab8-8ec555b86f7b,,Michael,364.41,9/22/2018,M,38,Moorebank,NSW,2018-09-22T10:06:57.000+0000,14.46,232952ffde894fe688699f109d4aab52,Australia,CUS-2142601169,150.95 -33.93,debit
authorized,1,,ACC-1222300524,AUD,151.23 -33.94,POS,02bfed71-b829-462d-bcf4-7f143ca7766b,,Michael,357.58,9/22/2018,M,38,Croydon,NSW,2018-09-22T19:56:22.000+0000,6.83,e55cb2bae8584d26b466463a0eea9feb,Australia,CUS-2142601169,151.13 -33.87,debit
authorized,1,,ACC-1222300524,AUD,151.23 -33.94,POS,7d323148-3f01-4b5e-8645-221ccd753fe4,,Michael,331.92,9/24/2018,M,38,Rosehill,NSW,2018-09-24T09:43:22.000+0000,25.66,92ec484bb6b14812b3fa9b09e64b4e3b,Australia,CUS-2142601169,151.02 -33.82,debit
authorized,1,,ACC-1222300524,AUD,151.23 -33.94,POS,ed1b9b0c-c647-4257-963a-01cad02e6944,,Michael,313.44,9/24/2018,M,38,Eastgardens,NSW,2018-09-24T10:38:02.000+0000,18.48,bc4d041881e44f9ab6f7217e98cc27d6,Australia,CUS-2142601169,151.22 -33.94,debit
authorized,1,,ACC-1222300524,AUD,151.23 -33.94,POS,914cea98-2f5a-4ee4-b8b1-441ff0d41bf8,,Michael,299.28,9/24/2018,M,38,Peakhurst,NSW,2018-09-24T17:21:22.000+0000,14.16,b31281a75caf44a1a0d52db3e08042f5,Australia,CUS-2142601169,151.07 -33.96,debit
authorized,1,,ACC-1222300524,AUD,151.23 -33.94,POS,90bcca1c-37b3-4e43-8320-e6886b13dc71,,Michael,281.81,9/24/2018,M,38,Hammondville,NSW,2018-09-24T18:31:25.000+0000,17.47,e3d09d41594b404fa1b2c58e7d80361c,Australia,CUS-2142601169,150.95 -33.95,debit
authorized,1,,ACC-1222300524,AUD,151.23 -33.94,POS,0b987f8d-d345-4b1c-8113-b433631aae15,,Michael,275.52,9/24/2018,M,38,Liverpool,NSW,2018-09-24T21:16:45.000+0000,6.29,fdbc15c910244b3ab8f18bf0b32882d9,Australia,CUS-2142601169,150.92 -33.92,debit
authorized,1,,ACC-1222300524,AUD,151.23 -33.94,POS,a57eacaa-1a0f-4de6-8245-c193f5bb530f,,Michael,252.93,9/25/2018,M,38,Casula,NSW,2018-09-25T09:24:01.000+0000,22.59,5d402dc443f04e40a477155454a70180,Australia,CUS-2142601169,150.91 -33.94,debit
authorized,1,,ACC-1222300524,AUD,151.23 -33.94,SALES-POS,c0b5acb9-1ee4-411f-a28c-d4b707f8a46b,,Michael,247.78,9/25/2018,M,38,Epping,NSW,2018-09-25T10:02:27.000+0000,5.15,9c2635dfa3cc4f9f838e403268b16ef4,Australia,CUS-2142601169,151.07 -33.78,debit
authorized,1,,ACC-1222300524,AUD,151.23 -33.94,POS,848f6f12-a594-461b-aaf5-72b7712ded60,,Michael,211.13,9/25/2018,M,38,Geelong,VIC,2018-09-25T11:42:36.000+0000,36.65,b84bb46bfacc43ce9bfca536f4ca867b,Australia,CUS-2142601169,144.36 -38.15,debit
posted,,0,ACC-1222300524,AUD,151.23 -33.94,PAY/SALARY,,0,Michael,1213.26,9/25/2018,M,38,,,2018-09-25T17:00:00.000+0000,1002.13,4b8ba9aadd5c439f93c1eeccc6180bac,Australia,CUS-2142601169,,credit
authorized,1,,ACC-1222300524,AUD,151.23 -33.94,POS,31f7772a-ba76-4ab4-bcbc-de9176844b25,,Michael,1204.08,9/26/2018,M,38,Liverpool,NSW,2018-09-26T09:11:12.000+0000,9.18,18bd099fdb2149c6ae0444d7e2e65025,Australia,CUS-2142601169,150.92 -33.92,debit
authorized,1,,ACC-1222300524,AUD,151.23 -33.94,POS,cda59185-3935-4d2c-91b0-b435ee6c94fb,,Michael,1196.33,9/26/2018,M,38,St Leonards,NSW,2018-09-26T10:06:44.000+0000,7.75,88ac65e081bc4aa495f5873007b2cae2,Australia,CUS-2142601169,151.19 -33.82,debit
authorized,1,,ACC-1222300524,AUD,151.23 -33.94,POS,a43ea02a-4dfd-4be4-a7b6-5438df923271,,Michael,1119.09,9/26/2018,M,38,Sydney,NSW,2018-09-26T10:30:50.000+0000,77.24,8f01899c8c32473897481f736c7ff246,Australia,CUS-2142601169,151.21 -33.86,debit
authorized,1,,ACC-1222300524,AUD,151.23 -33.94,SALES-POS,3487252d-4932-4c32-a137-4afb9966a517,,Michael,1106.08,9/26/2018,M,38,Sydney,NSW,2018-09-26T11:57:35.000+0000,13.01,0af35d8adfb841d99bc2f1ffbee586ea,Australia,CUS-2142601169,151.21 -33.87,debit
authorized,1,,ACC-1222300524,AUD,151.23 -33.94,SALES-POS,b21820e2-c98c-4f04-914f-7492254f7067,,Michael,1089.12,9/26/2018,M,38,Wallaroo,SA,2018-09-26T12:48:53.000+0000,16.96,2cf35bfdddb247e2876a706706fcd0ad,Australia,CUS-2142601169,137.62 -33.93,debit
authorized,1,,ACC-1222300524,AUD,151.23 -33.94,POS,22b641b6-f2e4-4abd-9fc6-6a5a3b375ff2,,Michael,1079.71,9/26/2018,M,38,Werrington County,NSW,2018-09-26T15:22:08.000+0000,9.41,f5563d3f997440108de0401be4467ee6,Australia,CUS-2142601169,150.74 -33.75,debit
authorized,1,,ACC-1222300524,AUD,151.23 -33.94,POS,bc1d521f-0e20-483f-84b1-0462893ab4e9,,Michael,1073.46,9/27/2018,M,38,Miller,NSW,2018-09-27T10:24:45.000+0000,6.25,ded94d63051d4ff68c07791c69176737,Australia,CUS-2142601169,150.88 -33.92,debit
authorized,1,,ACC-1222300524,AUD,151.23 -33.94,SALES-POS,b9510d80-80d9-4fe5-b712-523881bfff75,,Michael,1061.9,9/27/2018,M,38,Busselton,WA,2018-09-27T11:41:12.000+0000,11.56,1686b90470f74548b7d5cb6ab64486f3,Australia,CUS-2142601169,115.34 -33.65,debit
authorized,1,,ACC-1222300524,AUD,151.23 -33.94,SALES-POS,c54e03a8-bd5e-482e-b152-309c4471f5fc,,Michael,1052.84,9/27/2018,M,38,Mascot,NSW,2018-09-27T15:17:08.000+0000,9.06,84f968b068c34a0ba60abc207db7f083,Australia,CUS-2142601169,151.2 -33.93,debit
posted,,,ACC-1222300524,AUD,151.23 -33.94,PAYMENT,,,Michael,980.31,9/27/2018,M,38,,,2018-09-27T19:00:00.000+0000,50,e036d5b1edb34919a824c5c3155a55a1,Australia,CUS-2142601169,,debit
authorized,1,,ACC-1222300524,AUD,151.23 -33.94,POS,34254520-3daa-49b5-8267-7f5499ed69a5,,Michael,1030.31,9/27/2018,M,38,Greenacre,NSW,2018-09-27T19:07:15.000+0000,22.53,9d3faf3ff2b746c5a3a99c6264cb023c,Australia,CUS-2142601169,151.06 -33.91,debit
authorized,1,,ACC-1222300524,AUD,151.23 -33.94,SALES-POS,a1ca1b7e-a737-4fc8-b070-3e606f52c0d6,,Michael,974.88,9/28/2018,M,38,Margaret River,WA,2018-09-28T08:04:39.000+0000,5.43,171c240078c94773a8fcd0c55eb5bf97,Australia,CUS-2142601169,115.07 -33.95,debit
authorized,1,,ACC-1222300524,AUD,151.23 -33.94,POS,579e51c0-f568-47cc-93a3-b0764131af81,,Michael,958.68,9/28/2018,M,38,Yagoona,NSW,2018-09-28T09:07:23.000+0000,16.2,2d68ffdc05294fdbaa76026d1c378716,Australia,CUS-2142601169,151.04 -33.89,debit
authorized,0,,ACC-1222300524,AUD,151.23 -33.94,POS,dc7b49e7-2598-4e97-884d-953ee606ab1b,,Michael,940.37,9/28/2018,M,38,Liverpool,NSW,2018-09-28T16:00:39.000+0000,18.31,f7cbd52078064a48812d1814b59558c0,Australia,CUS-2142601169,150.92 -33.92,debit
authorized,1,,ACC-1222300524,AUD,151.23 -33.94,SALES-POS,9fafd25e-2baa-44ee-8ca3-bd2edfcd9150,,Michael,914.25,9/28/2018,M,38,Liverpool,NSW,2018-09-28T22:00:18.000+0000,26.12,66cd13316bc14c3c9309c212c03ba653,Australia,CUS-2142601169,150.92 -33.91,debit
authorized,1,,ACC-1222300524,AUD,151.23 -33.94,SALES-POS,f6cb6b79-8707-4c6d-a6bc-2b2012de5aed,,Michael,885.47,9/29/2018,M,38,Pyrmont,NSW,2018-09-29T10:46:02.000+0000,28.78,0653e6e86aca4273bf6b7e15eeb5d8f9,Australia,CUS-2142601169,151.19 -33.87,debit
authorized,1,,ACC-1222300524,AUD,151.23 -33.94,SALES-POS,b71b927f-3c14-4f05-92ee-842378fa8293,,Michael,879.06,9/29/2018,M,38,Mascot,NSW,2018-09-29T14:50:08.000+0000,6.41,421e107ce6d74c8bba7925bbed1d596e,Australia,CUS-2142601169,151.19 -33.93,debit
authorized,0,,ACC-1222300524,AUD,151.23 -33.94,SALES-POS,f0517635-0ebe-4a8c-815c-b726f570b5cf,,Michael,862.46,9/29/2018,M,38,Emerton,NSW,2018-09-29T18:50:39.000+0000,16.6,a03017e012284d30ae2fd86c7c4f5df6,Australia,CUS-2142601169,150.81 -33.74,debit
authorized,1,,ACC-1222300524,AUD,151.23 -33.94,POS,668f860c-514a-4f52-a2a5-b8651b2f61d9,,Michael,850.73,9/29/2018,M,38,Punchbowl,NSW,2018-09-29T19:36:31.000+0000,11.73,e1d74e8da06f4cf18f230e4fe72cf258,Australia,CUS-2142601169,151.04 -33.94,debit
authorized,1,,ACC-1222300524,AUD,151.23 -33.94,POS,ad5f71d0-7acb-475b-943d-db95b7abf4ca,,Michael,832.26,9/29/2018,M,38,Sydney,NSW,2018-09-29T22:26:25.000+0000,18.47,3fd3b1dec5c24fbcb5c07bad72585870,Australia,CUS-2142601169,151.21 -33.87,debit
authorized,1,,ACC-1222300524,AUD,151.23 -33.94,SALES-POS,4bc0e750-4818-4aec-af42-3be72ef0de7b,,Michael,823.24,9/30/2018,M,38,Penrith,NSW,2018-09-30T04:54:26.000+0000,9.02,1d9503a0936a4720b1ed04ed1649f36f,Australia,CUS-2142601169,150.69 -33.75,debit
authorized,1,,ACC-1222300524,AUD,151.23 -33.94,SALES-POS,604ad808-441d-43dd-9d1d-559649785f90,,Michael,802.16,9/30/2018,M,38,Blacktown,NSW,2018-09-30T21:26:34.000+0000,21.08,599b3ece28dd45cebf4b853d2f9edd90,Australia,CUS-2142601169,150.91 -33.77,debit
authorized,1,,ACC-1222300524,AUD,151.23 -33.94,POS,02174352-993c-4f6f-a379-18d6a710ada0,,Michael,782.93,9/30/2018,M,38,Ryde,NSW,2018-09-30T21:33:52.000+0000,19.23,6f247ef2529b4e1eb1fce1fbe4ece9d2,Australia,CUS-2142601169,151.11 -33.81,debit
authorized,0,,ACC-1222300524,AUD,151.23 -33.94,SALES-POS,7163ba4e-86e2-4146-b5e1-033b0a1d43d2,,Michael,753.36,10/1/2018,M,38,Melbourne,VIC,2018-10-01T00:23:19.000+0000,29.57,f077102cbe80453eabf96683eafc8496,Australia,CUS-2142601169,144.98 -37.84,debit
authorized,0,,ACC-1222300524,AUD,151.23 -33.94,POS,aee28413-5126-40ac-909a-2d91cafad528,,Michael,744.92,10/1/2018,M,38,Macquarie Park,NSW,2018-10-01T01:26:53.000+0000,8.44,0c9bdb3d9298473b9f47dc08988c8d7a,Australia,CUS-2142601169,151.12 -33.78,debit
authorized,1,,ACC-1222300524,AUD,151.23 -33.94,SALES-POS,a06611b8-173d-42ec-8cc6-874fa5d6fee5,,Michael,736.71,10/1/2018,M,38,Sydney,NSW,2018-10-01T07:19:59.000+0000,8.21,0588ed5db65a49b3a4728e66677a86d6,Australia,CUS-2142601169,151.21 -33.87,debit
authorized,1,,ACC-1222300524,AUD,151.23 -33.94,POS,176a01ec-0cd5-4763-88e5-563d120ed7ad,,Michael,710.18,10/1/2018,M,38,Brisbane City,QLD,2018-10-01T13:24:52.000+0000,26.53,1cfefa8d1d1b40b68c2b5c0150afd4fc,Australia,CUS-2142601169,153.02 -27.47,debit
authorized,1,,ACC-1222300524,AUD,151.23 -33.94,POS,898045e0-b5a7-4466-a793-21a32b32f41b,,Michael,691.42,10/2/2018,M,38,Padstow,NSW,2018-10-02T01:43:47.000+0000,18.76,3639beba0ba04a71b6d5b98cfe1be46e,Australia,CUS-2142601169,151.04 -33.95,debit
authorized,1,,ACC-1222300524,AUD,151.23 -33.94,POS,5024d6e4-302c-40df-aa6b-8906910ba0db,,Michael,683.36,10/2/2018,M,38,Manly,NSW,2018-10-02T09:04:33.000+0000,8.06,e076551783ae4cbfa65f222e74bc7781,Australia,CUS-2142601169,151.29 -33.8,debit
authorized,1,,ACC-1222300524,AUD,151.23 -33.94,SALES-POS,bd55b2be-eda5-45e8-8a91-053eafbd5480,,Michael,677.4,10/2/2018,M,38,Bridgetown,WA,2018-10-02T09:44:43.000+0000,5.96,8709c8e1b24b47be8ddda29547b4dc45,Australia,CUS-2142601169,116.14 -33.96,debit
authorized,0,,ACC-1222300524,AUD,151.23 -33.94,POS,69092272-47e1-4a35-9dcc-683f750cb571,,Michael,615.55,10/2/2018,M,38,Bass Hill,NSW,2018-10-02T09:58:07.000+0000,61.85,a2da02a8db1445deb987fa573ed73fc8,Australia,CUS-2142601169,150.99 -33.9,debit
authorized,0,,ACC-1222300524,AUD,151.23 -33.94,SALES-POS,78a916e4-135e-4a54-bbb8-cd6689eb6967,,Michael,602.23,10/2/2018,M,38,Earlwood,NSW,2018-10-02T11:21:01.000+0000,13.32,32fa36c433e34a6da207740be7eefad4,Australia,CUS-2142601169,151.11 -33.93,debit
authorized,1,,ACC-1222300524,AUD,151.23 -33.94,SALES-POS,aa5aa2e9-e9b4-46a6-a8ad-d723edc8e77d,,Michael,590.36,10/2/2018,M,38,Green Valley,NSW,2018-10-02T14:43:01.000+0000,11.87,a1347dda53d041d8a2ef7a192264b0f1,Australia,CUS-2142601169,150.87 -33.91,debit
posted,,0,ACC-1222300524,AUD,151.23 -33.94,PAY/SALARY,,0,Michael,1592.49,10/2/2018,M,38,,,2018-10-02T17:00:00.000+0000,1002.13,80224f315b0c45f4ab5d81fe51be6be6,Australia,CUS-2142601169,,credit
posted,,,ACC-1222300524,AUD,151.23 -33.94,PAYMENT,,,Michael,1490.49,10/2/2018,M,38,,,2018-10-02T23:00:00.000+0000,102,65ebf6aff5c646b192ccca83f021a20d,Australia,CUS-2142601169,,debit
authorized,1,,ACC-1222300524,AUD,151.23 -33.94,SALES-POS,2417b1fb-18e7-4f7a-83e3-bbe74963d5e3,,Michael,1470.73,10/3/2018,M,38,Moorebank,NSW,2018-10-03T09:42:46.000+0000,19.76,1dcf3a8ee06d4e669d0c2a08ccb1f10e,Australia,CUS-2142601169,150.97 -33.93,debit
authorized,1,,ACC-1222300524,AUD,151.23 -33.94,SALES-POS,3278e728-f1be-42d4-9769-908afa601ff6,,Michael,1464.12,10/3/2018,M,38,Hurstville,NSW,2018-10-03T10:22:37.000+0000,6.61,7fa1b5d0f16248618fa2d57304f51196,Australia,CUS-2142601169,151.1 -33.97,debit
authorized,1,,ACC-1222300524,AUD,151.23 -33.94,POS,aa6e2d44-eada-49c5-b7b2-839c58acbc22,,Michael,1457.57,10/3/2018,M,38,Blacktown,NSW,2018-10-03T11:36:08.000+0000,6.55,308558e5c22e471c95f32a03a03563ce,Australia,CUS-2142601169,150.9 -33.78,debit
authorized,1,,ACC-1222300524,AUD,151.23 -33.94,POS,a1ca1b7e-a737-4fc8-b070-3e606f52c0d6,,Michael,1451.29,10/3/2018,M,38,Margaret River,WA,2018-10-03T13:11:28.000+0000,6.28,c36b33b2a2694f3bbe9263338ab84e16,Australia,CUS-2142601169,115.07 -33.95,debit
authorized,1,,ACC-1222300524,AUD,151.23 -33.94,POS,455c2862-fa06-4c7f-bdee-cfcf63095c66,,Michael,1437.88,10/3/2018,M,38,Clovelly,NSW,2018-10-03T14:09:47.000+0000,13.41,d13a592f2f594dadb84469bdde4ff9a5,Australia,CUS-2142601169,151.26 -33.91,debit
posted,,,ACC-1222300524,AUD,151.23 -33.94,PAYMENT,,,Michael,1387.88,10/4/2018,M,38,,,2018-10-04T19:00:00.000+0000,50,5b5f3cba2649403dbafd1456a4eb8c15,Australia,CUS-2142601169,,debit
authorized,1,,ACC-1222300524,AUD,151.23 -33.94,POS,b1a88e2a-7b07-4cb0-bc9b-547dd5d70f85,,Michael,1385.49,10/5/2018,M,38,Margaret River,WA,2018-10-05T02:13:31.000+0000,2.39,3f3e9acd1e764981bc6349bf7ede84e8,Australia,CUS-2142601169,115.07 -33.95,debit
authorized,1,,ACC-1222300524,AUD,151.23 -33.94,POS,ca504361-fa5f-4c0a-a6f5-800343d80b98,,Michael,1368.64,10/5/2018,M,38,Brighton-Le-Sands,NSW,2018-10-05T04:37:18.000+0000,16.85,d9bfd738588f41cabbd14587019bac90,Australia,CUS-2142601169,151.16 -33.96,debit
authorized,1,,ACC-1222300524,AUD,151.23 -33.94,POS,e7176f10-4bb2-453e-85c6-3aebd8fb7408,,Michael,1347.86,10/5/2018,M,38,Blacktown,NSW,2018-10-05T12:38:19.000+0000,20.78,109ed7a9508c47aa83355c8324acaa47,Australia,CUS-2142601169,150.9 -33.77,debit
authorized,1,,ACC-1222300524,AUD,151.23 -33.94,SALES-POS,ecc0b9d5-ce2a-4eec-8507-13f65df181da,,Michael,1334.15,10/5/2018,M,38,Campsie,NSW,2018-10-05T14:19:19.000+0000,13.71,a8324da9135e47409298e4cde1d83805,Australia,CUS-2142601169,151.1 -33.91,debit
authorized,1,,ACC-1222300524,AUD,151.23 -33.94,POS,f7643a90-424d-46ec-97ee-320406f77268,,Michael,1327.33,10/5/2018,M,38,Springwood,NSW,2018-10-05T15:18:29.000+0000,6.82,d7ea34ced504497c9fde177c7bc8e45d,Australia,CUS-2142601169,150.56 -33.7,debit
authorized,1,,ACC-1222300524,AUD,151.23 -33.94,POS,87b6a0b0-8b78-4e4c-b9d8-17a5e8956c0b,,Michael,1297.91,10/5/2018,M,38,Parramatta,NSW,2018-10-05T15:35:17.000+0000,29.42,2ff44bb91eb64f13ac34ba7e94c424c0,Australia,CUS-2142601169,151 -33.81,debit
authorized,0,,ACC-1222300524,AUD,151.23 -33.94,SALES-POS,2d6a19c0-bc02-44a9-9014-aaf637d16225,,Michael,1290.56,10/5/2018,M,38,Manly,NSW,2018-10-05T17:03:57.000+0000,7.35,3eb0fe0377e544fb88014f40384e3830,Australia,CUS-2142601169,151.29 -33.8,debit
authorized,0,,ACC-1222300524,AUD,151.23 -33.94,POS,3153c43b-b27d-4a61-b92c-e3f233564081,,Michael,1283.3,10/5/2018,M,38,Coogee,NSW,2018-10-05T18:49:47.000+0000,7.26,e90a4e43475c4def8535253fff785837,Australia,CUS-2142601169,151.26 -33.92,debit
authorized,1,,ACC-1222300524,AUD,151.23 -33.94,SALES-POS,e9074350-40c1-46e0-9acd-57f458e461d6,,Michael,1254.02,10/5/2018,M,38,Casula,NSW,2018-10-05T19:54:39.000+0000,29.28,ad479be2940541e1984918d287fe70a5,Australia,CUS-2142601169,150.89 -33.96,debit
authorized,1,,ACC-1222300524,AUD,151.23 -33.94,SALES-POS,6ad3211d-0c5e-46a7-b768-a094d85fe5cf,,Michael,1235.97,10/6/2018,M,38,Punchbowl,NSW,2018-10-06T08:00:23.000+0000,18.05,f26ef936f7f74e66bd43106b37489e72,Australia,CUS-2142601169,151.06 -33.93,debit
authorized,0,,ACC-1222300524,AUD,151.23 -33.94,POS,f6fe96a8-b6c9-403c-b187-708a20528584,,Michael,673.21,10/6/2018,M,38,Punchbowl,NSW,2018-10-06T10:36:31.000+0000,562.76,0f7c6beb52bd495eacf1df88eb793732,Australia,CUS-2142601169,151.06 -33.94,debit
authorized,1,,ACC-1222300524,AUD,151.23 -33.94,POS,2fe4b555-6114-420d-92ac-1b9ab3294c8e,,Michael,659.02,10/6/2018,M,38,Liverpool,NSW,2018-10-06T14:35:02.000+0000,14.19,9e35ce296b014f7da33347a0f3217e4b,Australia,CUS-2142601169,150.92 -33.91,debit
authorized,1,,ACC-1222300524,AUD,151.23 -33.94,POS,018eeae6-d3d9-4c1c-b74c-cf436ae9fb58,,Michael,653.87,10/6/2018,M,38,Seven Hills,NSW,2018-10-06T22:30:42.000+0000,5.15,c31f887186874ba7bb9013aac196f1bd,Australia,CUS-2142601169,150.94 -33.77,debit
authorized,1,,ACC-1222300524,AUD,151.23 -33.94,SALES-POS,e9c95a83-b406-414e-b447-0ec282d38faf,,Michael,644.75,10/6/2018,M,38,Margaret River,WA,2018-10-06T22:48:34.000+0000,9.12,47299db04c55462d8273903b208f4602,Australia,CUS-2142601169,115.07 -33.95,debit
authorized,0,,ACC-1222300524,AUD,151.23 -33.94,POS,77911254-b808-4b74-abeb-64c39634f202,,Michael,622.53,10/7/2018,M,38,Alexandria,NSW,2018-10-07T18:54:44.000+0000,22.22,622b7ac047f84a20b1c8dd32099641e0,Australia,CUS-2142601169,151.19 -33.9,debit
authorized,1,,ACC-1222300524,AUD,151.23 -33.94,POS,bdcf9ea0-9997-4409-b44f-a05b96fb41d8,,Michael,612.55,10/8/2018,M,38,Melbourne,VIC,2018-10-08T09:21:22.000+0000,9.98,61812beb78bd4d8fa4fad3018384f20b,Australia,CUS-2142601169,144.98 -37.85,debit
authorized,1,,ACC-1222300524,AUD,151.23 -33.94,POS,bea54ad1-8c10-4b04-a57f-9309f92c8093,,Michael,589.52,10/8/2018,M,38,Parramatta,NSW,2018-10-08T14:23:35.000+0000,23.03,86d24e76c83448bb855bbd7fe8539d34,Australia,CUS-2142601169,151 -33.81,debit
authorized,1,,ACC-1222300524,AUD,151.23 -33.94,POS,ba206cd5-781c-43b7-aace-f65100831212,,Michael,565.53,10/9/2018,M,38,Casula,NSW,2018-10-09T12:36:31.000+0000,23.99,9a05c4869dfd4082aee026010cb77a8e,Australia,CUS-2142601169,150.91 -33.95,debit
authorized,1,,ACC-1222300524,AUD,151.23 -33.94,POS,e449ea4c-04e0-4958-bcd1-6a5d531f8e8c,,Michael,559.1,10/9/2018,M,38,Alexandria,NSW,2018-10-09T13:20:26.000+0000,6.43,2ac50172d2404024887d8cdb63bd3abb,Australia,CUS-2142601169,151.2 -33.92,debit
posted,,0,ACC-1222300524,AUD,151.23 -33.94,PAY/SALARY,,0,Michael,1561.23,10/9/2018,M,38,,,2018-10-09T17:00:00.000+0000,1002.13,02fbb74ca47541ac859702f3c8d6d3f8,Australia,CUS-2142601169,,credit
authorized,1,,ACC-1222300524,AUD,151.23 -33.94,POS,4199792e-da85-4e56-b456-c9e06e96e52c,,Michael,1529.91,10/10/2018,M,38,Randwick,NSW,2018-10-10T17:57:24.000+0000,31.32,ec3b1a7bab7b435ca11976093d70bef0,Australia,CUS-2142601169,151.24 -33.92,debit
authorized,1,,ACC-1222300524,AUD,151.23 -33.94,SALES-POS,dd23bec4-0f94-4936-957a-3b2960a40df3,,Michael,1511.29,10/10/2018,M,38,Homebush West,NSW,2018-10-10T21:04:59.000+0000,18.62,c5f2d0aec9244b509ebaddd869731cc2,Australia,CUS-2142601169,151.07 -33.87,debit
authorized,1,,ACC-1222300524,AUD,151.23 -33.94,SALES-POS,52be1d52-533e-45ec-8f27-7721f9535c87,,Michael,1474.61,10/10/2018,M,38,Green Valley,NSW,2018-10-10T21:42:29.000+0000,36.68,c6a1a9aa752b4a89b767e40662c578a9,Australia,CUS-2142601169,150.87 -33.91,debit
authorized,1,,ACC-1222300524,AUD,151.23 -33.94,POS,b3a5109d-7d66-4526-bd50-389ddd02c27f,,Michael,1458.64,10/11/2018,M,38,Chipping Norton,NSW,2018-10-11T01:18:19.000+0000,15.97,3a438225136846b8954915b4ecf407f7,Australia,CUS-2142601169,150.95 -33.93,debit
authorized,0,,ACC-1222300524,AUD,151.23 -33.94,POS,ce553c72-ed0c-4e30-b730-164b6af76520,,Michael,1453.24,10/11/2018,M,38,Blacktown,NSW,2018-10-11T08:11:23.000+0000,5.4,5e5c82bc32e24a3bba8957418d4ac0c0,Australia,CUS-2142601169,150.91 -33.77,debit
authorized,1,,ACC-1222300524,AUD,151.23 -33.94,POS,f6a67a8d-ad19-4e99-b4ce-6166942bb92f,,Michael,1442.57,10/11/2018,M,38,Milperra,NSW,2018-10-11T08:18:19.000+0000,10.67,c71f7374021944758ad018a30fd7da01,Australia,CUS-2142601169,150.99 -33.93,debit
posted,,,ACC-1222300524,AUD,151.23 -33.94,PAYMENT,,,Michael,1392.57,10/11/2018,M,38,,,2018-10-11T19:00:00.000+0000,50,5335b0bad70641329ca1292e5ae5eef7,Australia,CUS-2142601169,,debit
authorized,0,,ACC-1222300524,AUD,151.23 -33.94,POS,1be15a76-9a7e-4a85-99cf-f065b1dc9591,,Michael,1358.8,10/14/2018,M,38,Hurstville,NSW,2018-10-14T13:56:29.000+0000,33.77,fa0d33ea41ce4037a269679c06f3a1f3,Australia,CUS-2142601169,151.1 -33.97,debit
authorized,1,,ACC-1222300524,AUD,151.23 -33.94,POS,5c134d37-923c-49b8-8559-6980b0047703,,Michael,1343.26,10/14/2018,M,38,Bankstown,NSW,2018-10-14T17:55:34.000+0000,15.54,f2d880b51dfd4ba18396c687dd84ebcd,Australia,CUS-2142601169,151.03 -33.92,debit
authorized,1,,ACC-1222300524,AUD,151.23 -33.94,POS,9fafd25e-2baa-44ee-8ca3-bd2edfcd9150,,Michael,1317.39,10/14/2018,M,38,Liverpool,NSW,2018-10-14T20:23:54.000+0000,25.87,c299385314814fef8e52991eb6867853,Australia,CUS-2142601169,150.92 -33.91,debit
authorized,1,,ACC-1222300524,AUD,151.23 -33.94,POS,e9c95a83-b406-414e-b447-0ec282d38faf,,Michael,1306.79,10/14/2018,M,38,Margaret River,WA,2018-10-14T21:38:36.000+0000,10.6,ea5ca0aa94b444e3b665644dc477e034,Australia,CUS-2142601169,115.07 -33.95,debit
authorized,1,,ACC-1222300524,AUD,151.23 -33.94,SALES-POS,9980b7fe-3d5f-4aee-9ed0-74f4b050a175,,Michael,1296.97,10/15/2018,M,38,Bankstown,NSW,2018-10-15T08:08:21.000+0000,9.82,7e074ea940da4f379dc18cf671b786be,Australia,CUS-2142601169,151.04 -33.92,debit
authorized,0,,ACC-1222300524,AUD,151.23 -33.94,SALES-POS,74991e65-5c75-42fc-8d01-ae06d2d66179,,Michael,1283.86,10/15/2018,M,38,Liverpool,NSW,2018-10-15T10:27:04.000+0000,13.11,9f1a7cfb19ed4b1c9d7c812de6051556,Australia,CUS-2142601169,150.92 -33.93,debit
authorized,1,,ACC-1222300524,AUD,151.23 -33.94,POS,591082c5-10c9-421c-bb90-e2f76180cf58,,Michael,1277.53,10/15/2018,M,38,Sydney,NSW,2018-10-15T13:47:59.000+0000,6.33,ea54af33f576473e93c7509dedf2a435,Australia,CUS-2142601169,151.21 -33.86,debit
authorized,0,,ACC-1222300524,AUD,151.23 -33.94,POS,40193d6a-141e-40c3-bbc9-231721981719,,Michael,1265.18,10/15/2018,M,38,Sydney,NSW,2018-10-15T17:34:32.000+0000,12.35,c94a3bc807404829a3ebbdb29e3c4cc2,Australia,CUS-2142601169,151.21 -33.86,debit
authorized,1,,ACC-1222300524,AUD,151.23 -33.94,SALES-POS,f3419ce8-536c-4dcf-9d0c-12c9aed8c55c,,Michael,1259.81,10/15/2018,M,38,Bankstown,NSW,2018-10-15T21:17:05.000+0000,5.37,1146e87387aa4321abd081347c27bcda,Australia,CUS-2142601169,151.04 -33.92,debit
authorized,1,,ACC-1222300524,AUD,151.23 -33.94,SALES-POS,b82483f8-57c4-4f6f-92ff-4f7b680495d2,,Michael,1250.86,10/16/2018,M,38,Busselton,WA,2018-10-16T04:28:53.000+0000,8.95,16bf3862447e44649dbd372380a58e1c,Australia,CUS-2142601169,115.34 -33.65,debit
authorized,1,,ACC-1222300524,AUD,151.23 -33.94,POS,96bf0a2c-2a73-4486-8228-8aa93ae68ba4,,Michael,1242.89,10/16/2018,M,38,Liverpool,NSW,2018-10-16T10:43:10.000+0000,7.97,1dcbf619b995469da9956a1d291bd459,Australia,CUS-2142601169,150.92 -33.92,debit
posted,,0,ACC-1222300524,AUD,151.23 -33.94,PAY/SALARY,,0,Michael,2245.02,10/16/2018,M,38,,,2018-10-16T17:00:00.000+0000,1002.13,84c8c8bff2c24bbfb644808e2783e1b3,Australia,CUS-2142601169,,credit
authorized,1,,ACC-1222300524,AUD,151.23 -33.94,SALES-POS,e14b1577-0809-44e7-8af3-f5ce6bcbfc25,,Michael,2230.78,10/17/2018,M,38,Sydney,NSW,2018-10-17T07:36:39.000+0000,14.24,a79e7d250eac4c75bcae0d0fcc196f16,Australia,CUS-2142601169,151.18 -33.93,debit
authorized,1,,ACC-1222300524,AUD,151.23 -33.94,SALES-POS,03a40eb3-377c-4693-9202-6f237e87f1f2,,Michael,2190.74,10/17/2018,M,38,Baulkham Hills,NSW,2018-10-17T08:59:07.000+0000,40.04,64edf66dc6b544fa9196e9355877a9cc,Australia,CUS-2142601169,150.97 -33.73,debit
authorized,1,,ACC-1222300524,AUD,151.23 -33.94,POS,24879f07-b76f-4d5f-a376-1f2720c0c29a,,Michael,2177.54,10/17/2018,M,38,Saint Marys,NSW,2018-10-17T09:55:11.000+0000,13.2,2f554f38a594423bad4193faf8332069,Australia,CUS-2142601169,150.77 -33.77,debit
authorized,1,,ACC-1222300524,AUD,151.23 -33.94,POS,06ffce70-5bf8-461b-95d2-ea34885759c8,,Michael,2169.19,10/17/2018,M,38,Kogarah,NSW,2018-10-17T11:01:23.000+0000,8.35,7e3b8c9a7d4d46eb918cb2ba3f2b3309,Australia,CUS-2142601169,151.13 -33.96,debit
authorized,1,,ACC-1222300524,AUD,151.23 -33.94,POS,e9569816-7d10-403a-8ca2-4ae5fffe10bb,,Michael,2159.82,10/17/2018,M,38,Liverpool,NSW,2018-10-17T11:26:23.000+0000,9.37,13787ab3f1a14e37ad68fbd94a8c518b,Australia,CUS-2142601169,150.92 -33.92,debit
authorized,1,,ACC-1222300524,AUD,151.23 -33.94,POS,e597c518-a64e-4091-a7a2-0bf8bc8e7159,,Michael,2150.47,10/17/2018,M,38,Bridgetown,WA,2018-10-17T11:51:23.000+0000,9.35,e12c3f0f058b47c5bf60c80b74943460,Australia,CUS-2142601169,116.14 -33.96,debit
authorized,1,,ACC-1222300524,AUD,151.23 -33.94,POS,40efb93c-93d5-4666-9b19-df4341aaa043,,Michael,2130.39,10/17/2018,M,38,Sydney,NSW,2018-10-17T13:55:11.000+0000,20.08,7d827e4549384c099246779b8831393d,Australia,CUS-2142601169,151.21 -33.87,debit
authorized,1,,ACC-1222300524,AUD,151.23 -33.94,SALES-POS,40ecb26c-e294-4d59-b535-878d19330463,,Michael,2113.22,10/17/2018,M,38,Rozelle,NSW,2018-10-17T14:24:26.000+0000,17.17,057814726f1348ccb110c6fc2f36e226,Australia,CUS-2142601169,151.17 -33.86,debit
authorized,0,,ACC-1222300524,AUD,151.23 -33.94,POS,8213e3af-7b48-4dde-8541-a1f7a0e5030d,,Michael,2105.91,10/17/2018,M,38,Hurstville,NSW,2018-10-17T19:39:44.000+0000,7.31,900a04a7b9964b9c8416192f47ad39aa,Australia,CUS-2142601169,151.11 -33.97,debit
authorized,1,,ACC-1222300524,AUD,151.23 -33.94,POS,bb87b061-4673-4173-b9d7-13f95e3f72f0,,Michael,2102.04,10/18/2018,M,38,Westmead,NSW,2018-10-18T14:00:13.000+0000,3.87,ba648e2d5a694b4d8771273609d5ebc4,Australia,CUS-2142601169,150.99 -33.8,debit
authorized,1,,ACC-1222300524,AUD,151.23 -33.94,POS,dce0853b-745e-42f2-9e54-359e2aa99fdd,,Michael,2090.98,10/18/2018,M,38,Baulkham Hills,NSW,2018-10-18T14:21:57.000+0000,11.06,8958ee8d8ff74593b4ad42d2f2fffd99,Australia,CUS-2142601169,150.99 -33.76,debit
posted,,,ACC-1222300524,AUD,151.23 -33.94,PAYMENT,,,Michael,2040.98,10/18/2018,M,38,,,2018-10-18T19:00:00.000+0000,50,b2b4422c51eb4c19aee4459e78500144,Australia,CUS-2142601169,,debit
authorized,1,,ACC-1222300524,AUD,151.23 -33.94,SALES-POS,3de16e20-02c7-47cb-9ad8-98ce5b04d22a,,Michael,1951.87,10/18/2018,M,38,Sydney,NSW,2018-10-18T23:19:09.000+0000,89.11,eebdc14ee5024a51a3811f60c922370d,Australia,CUS-2142601169,151.21 -33.87,debit
authorized,1,,ACC-1222300524,AUD,151.23 -33.94,POS,e7478dc3-3708-4b13-9852-871c2381bfb5,,Michael,1926.87,10/18/2018,M,38,Hornsby,NSW,2018-10-18T23:39:59.000+0000,25,8f993f88ecac4e84b00a9956d72d6e4c,Australia,CUS-2142601169,151.1 -33.7,debit
authorized,0,,ACC-1222300524,AUD,151.23 -33.94,SALES-POS,ea333a5f-9d67-4fa9-9687-c35b260732df,,Michael,1922.11,10/19/2018,M,38,Kingsgrove,NSW,2018-10-19T11:49:49.000+0000,4.76,f4795ca97dae4230a26e470cf7cb8d2e,Australia,CUS-2142601169,151.1 -33.94,debit
authorized,1,,ACC-1222300524,AUD,151.23 -33.94,POS,54875e18-471a-4dd6-bcb0-53cff32e4a56,,Michael,1916.07,10/19/2018,M,38,Sydney Airport,NSW,2018-10-19T14:31:17.000+0000,6.04,acdeb5f0410d4e5fa5a2ccb32153dd05,Australia,CUS-2142601169,151.18 -33.93,debit
authorized,1,,ACC-1222300524,AUD,151.23 -33.94,POS,296a60e7-5693-4d50-8d33-b5b994093d2e,,Michael,1896.12,10/20/2018,M,38,Sydney,NSW,2018-10-20T11:08:52.000+0000,19.95,b965a2ef329e4f908a959923d0dccc99,Australia,CUS-2142601169,151.2 -33.86,debit
authorized,1,,ACC-1222300524,AUD,151.23 -33.94,POS,b19f0688-a296-4826-9865-9c9eb8940db3,,Michael,1855.75,10/20/2018,M,38,Peakhurst,NSW,2018-10-20T13:41:04.000+0000,40.37,ef0739983d12468ab6c33d6aa606b395,Australia,CUS-2142601169,151.06 -33.96,debit
authorized,0,,ACC-1222300524,AUD,151.23 -33.94,SALES-POS,a57eacaa-1a0f-4de6-8245-c193f5bb530f,,Michael,1830.71,10/20/2018,M,38,Casula,NSW,2018-10-20T14:15:54.000+0000,25.04,33700c6fae0f411c902cc0ea7bebb52a,Australia,CUS-2142601169,150.91 -33.94,debit
authorized,1,,ACC-1222300524,AUD,151.23 -33.94,SALES-POS,b0e3fc82-a4d3-4740-bfb1-e2339a5e96de,,Michael,1785.66,10/21/2018,M,38,Richmond,VIC,2018-10-21T13:23:19.000+0000,45.05,98036e3a80fa4285b1c3f90e1dbdb400,Australia,CUS-2142601169,145.01 -37.83,debit
authorized,1,,ACC-1222300524,AUD,151.23 -33.94,POS,b828e4d7-0d82-47fd-a4da-2b6cb543b96e,,Michael,1764.11,10/22/2018,M,38,Hinchinbrook,NSW,2018-10-22T10:32:11.000+0000,21.55,3ca35dd90d8848d389c29b6c7c12cdd6,Australia,CUS-2142601169,150.87 -33.91,debit
posted,,0,ACC-1222300524,AUD,151.23 -33.94,PAY/SALARY,,0,Michael,2758.28,10/23/2018,M,38,,,2018-10-23T17:00:00.000+0000,1002.13,38b5147f9a6641a2b8e0d1a0b8b9daaf,Australia,CUS-2142601169,,credit
authorized,1,,ACC-1222300524,AUD,151.23 -33.94,SALES-POS,e597c518-a64e-4091-a7a2-0bf8bc8e7159,,Michael,1756.15,10/23/2018,M,38,Bridgetown,WA,2018-10-23T17:58:34.000+0000,7.96,f7ebe2adc01d4b169dcabf61f59fb412,Australia,CUS-2142601169,116.14 -33.96,debit
authorized,1,,ACC-1222300524,AUD,151.23 -33.94,POS,51b5442f-31a4-44a4-bb86-bddb39381290,,Michael,2739.69,10/24/2018,M,38,Punchbowl,NSW,2018-10-24T10:06:31.000+0000,18.59,e0a087f3ea1f4111a04eb3ae4e2a7b17,Australia,CUS-2142601169,151.06 -33.93,debit
authorized,1,,ACC-1222300524,AUD,151.23 -33.94,SALES-POS,d377fe00-3eb5-4bb6-9546-31ff7875d454,,Michael,2321.06,10/24/2018,M,38,Artarmon,NSW,2018-10-24T15:00:15.000+0000,418.63,93ce4eedc86a439888dfc15c580d527a,Australia,CUS-2142601169,151.18 -33.81,debit
posted,,,ACC-1222300524,AUD,151.23 -33.94,PAYMENT,,,Michael,2271.06,10/25/2018,M,38,,,2018-10-25T19:00:00.000+0000,50,8100e63373ce47eeb792b26c06d2a35f,Australia,CUS-2142601169,,debit
authorized,0,,ACC-1222300524,AUD,151.23 -33.94,SALES-POS,cb39705d-436f-4b8b-b543-d339e092c99d,,Michael,2263.52,10/25/2018,M,38,Baulkham Hills,NSW,2018-10-25T22:38:08.000+0000,7.54,746d0f0e942a4b1092ea9eb93dd5534a,Australia,CUS-2142601169,150.96 -33.73,debit
authorized,1,,ACC-1222300524,AUD,151.23 -33.94,POS,e5ed6561-f07b-4255-8cfe-62f905a3416c,,Michael,2254.13,10/26/2018,M,38,Liverpool,NSW,2018-10-26T09:21:34.000+0000,9.39,a5be72dd4b614231bc060d7e8ef5f4b0,Australia,CUS-2142601169,150.92 -33.91,debit
authorized,0,,ACC-1222300524,AUD,151.23 -33.94,SALES-POS,438fdb3a-9c2c-45ac-9583-f138420f0d18,,Michael,2230.2,10/26/2018,M,38,Kadina,SA,2018-10-26T16:00:40.000+0000,23.93,bd68cd3b37c44656818ea16258f72b6c,Australia,CUS-2142601169,137.72 -33.96,debit
authorized,1,,ACC-1222300524,AUD,151.23 -33.94,POS,2f4e2a37-caf3-422f-9564-ff591d9a7dc7,,Michael,2152.41,10/26/2018,M,38,Sydney,NSW,2018-10-26T20:25:42.000+0000,77.79,7e4983e9caa649ea91c6108ce600e0f3,Australia,CUS-2142601169,151.2 -33.87,debit
authorized,0,,ACC-1222300524,AUD,151.23 -33.94,SALES-POS,62d50c71-3c47-48f5-9598-e0e0b0e7a21f,,Michael,2139.28,10/26/2018,M,38,Southbank,VIC,2018-10-26T22:21:34.000+0000,13.13,ba65245a82ef41bda73f08f04a6b56d4,Australia,CUS-2142601169,144.97 -37.82,debit
authorized,1,,ACC-1222300524,AUD,151.23 -33.94,POS,a71d5a48-83e3-44c4-96b1-72973a9880a4,,Michael,2129.24,10/27/2018,M,38,Manly,NSW,2018-10-27T02:02:29.000+0000,10.04,477ea7e6917c41e49ddfdd2fefe97244,Australia,CUS-2142601169,151.29 -33.8,debit
posted,,,ACC-1222300524,AUD,151.23 -33.94,PAYMENT,,,Michael,1900.24,10/27/2018,M,38,,,2018-10-27T05:00:00.000+0000,229,2a2e07057f864ce184331c51c5fad2a9,Australia,CUS-2142601169,,debit
authorized,0,,ACC-1222300524,AUD,151.23 -33.94,POS,438fdb3a-9c2c-45ac-9583-f138420f0d18,,Michael,1876.07,10/27/2018,M,38,Kadina,SA,2018-10-27T19:40:26.000+0000,24.17,86f624e23a1f4c5f8dd4f1ec2b5bca7c,Australia,CUS-2142601169,137.72 -33.96,debit
authorized,1,,ACC-1222300524,AUD,151.23 -33.94,POS,18505d09-546f-42ec-a296-07243abd3696,,Michael,1630.03,10/28/2018,M,38,Panania,NSW,2018-10-28T01:35:17.000+0000,246.04,2e3aff67b3904d199d32ee77e3992f00,Australia,CUS-2142601169,151 -33.96,debit
authorized,1,,ACC-1222300524,AUD,151.23 -33.94,POS,146cffd0-87c3-47e3-b0f3-815483a532b9,,Michael,1612.5,10/28/2018,M,38,Kadina,SA,2018-10-28T16:27:19.000+0000,17.53,aacb570ca55f4212bed9e1c3d977bdb0,Australia,CUS-2142601169,137.71 -33.96,debit
authorized,1,,ACC-1222300524,AUD,151.23 -33.94,POS,f798235c-1190-4fab-9a68-8f0ae5f841d8,,Michael,1571.63,10/28/2018,M,38,Wyalong,NSW,2018-10-28T16:43:59.000+0000,40.87,f7d75393c32c4e27bf144ae424bd1ad9,Australia,CUS-2142601169,147.26 -33.93,debit
authorized,1,,ACC-1222300524,AUD,151.23 -33.94,SALES-POS,9cb42fec-930a-47b2-a364-0d3872105e9c,,Michael,1557.8,10/28/2018,M,38,Parramatta,NSW,2018-10-28T21:14:35.000+0000,13.83,ff14af4280ac4c5ebe5dd98dd6470488,Australia,CUS-2142601169,151 -33.81,debit
authorized,1,,ACC-1222300524,AUD,151.23 -33.94,SALES-POS,e77e7118-9958-4ae0-8ecd-b705bde43c16,,Michael,1454.35,10/29/2018,M,38,Sydney,NSW,2018-10-29T17:49:59.000+0000,103.45,307fa3cfa75141618f9b35a647b900e2,Australia,CUS-2142601169,151.21 -33.87,debit
authorized,1,,ACC-1222300524,AUD,151.23 -33.94,SALES-POS,309aaeb5-6644-4f03-a09d-1d35d9d63c51,,Michael,1444.98,10/29/2018,M,38,Collaroy Plateau,NSW,2018-10-29T21:26:32.000+0000,9.37,720e81b36ba347ce8e5ada54344d391c,Australia,CUS-2142601169,151.29 -33.73,debit
authorized,1,,ACC-1222300524,AUD,151.23 -33.94,POS,2f5e2cd6-42cd-4a61-b068-f96af367c48e,,Michael,1433.08,10/30/2018,M,38,Sydney,NSW,2018-10-30T08:14:39.000+0000,11.9,bac2121aa1234bfe9dad55dfa4ad5a52,Australia,CUS-2142601169,151.21 -33.87,debit
authorized,1,,ACC-1222300524,AUD,151.23 -33.94,POS,11f18ded-66fb-4df5-b136-0a144fc8e9fd,,Michael,1409.57,10/30/2018,M,38,Rockdale,NSW,2018-10-30T16:16:07.000+0000,23.51,ec54cb36bdfd4dafa6dae4082cd10fd8,Australia,CUS-2142601169,151.14 -33.96,debit
posted,,0,ACC-1222300524,AUD,151.23 -33.94,PAY/SALARY,,0,Michael,2411.7,10/30/2018,M,38,,,2018-10-30T17:00:00.000+0000,1002.13,05181faded304452b4829105b1fa9261,Australia,CUS-2142601169,,credit
authorized,0,,ACC-1222300524,AUD,151.23 -33.94,SALES-POS,c517e9ce-fba4-4269-ac69-739d51ef969b,,Michael,2375.47,10/31/2018,M,38,Armidale,NSW,2018-10-31T10:23:11.000+0000,36.23,01b2fa3b2c304a2db74012bf84374177,Australia,CUS-2142601169,151.67 -30.52,debit
authorized,1,,ACC-1222300524,AUD,151.23 -33.94,SALES-POS,76f74eb9-c15b-49c1-8ab5-3edbd0bfcf12,,Michael,2370.45,10/31/2018,M,38,Alexandria,NSW,2018-10-31T14:15:02.000+0000,5.02,9ffbc8fe90bf42cd9fdc5f02c8d77cc0,Australia,CUS-2142601169,151.19 -33.91,debit
authorized,1,,ACC-1222300524,AUD,151.23 -33.94,SALES-POS,46950be0-90fe-4387-a8c9-e35650d486f6,,Michael,2359.92,10/31/2018,M,38,Randwick,NSW,2018-10-31T16:19:38.000+0000,10.53,4c91ed13c8e246d590e2565c941474fb,Australia,CUS-2142601169,151.24 -33.91,debit
authorized,1,,ACC-1222300524,AUD,151.23 -33.94,POS,aa8af5d1-53d4-448b-a612-6acd4b5bb310,,Michael,2340.25,10/31/2018,M,38,Newport,NSW,2018-10-31T17:19:46.000+0000,19.67,6c6e9ec3d6d647e391192a7338856d44,Australia,CUS-2142601169,151.31 -33.66,debit
authorized,0,,ACC-1222300524,AUD,151.23 -33.94,POS,85536a50-fecc-4eac-9d42-a423ae233dc1,,Michael,2321.06,10/31/2018,M,38,Penrith,NSW,2018-10-31T17:43:01.000+0000,19.19,cda53418938c41b2a8fe33105c53b383,Australia,CUS-2142601169,150.69 -33.75,debit